HITT Cardio	Running
morning run	Running
run	Running
treadmill	Running
d4acth / on	Running
U9nMi9n	Running
101piitacI	Running
Ran	Running
kan	Running
ran sprints	Running
kan sRootns	Running
sprints	Running
better performance than my first workout	Running
jogged	Running
llng ron	Running
tkedaj & ll	Running
running	Running
Hr # adm1il	Running
ran skipEtE	Running
ran uphill	Running
decTw1hon	Running
  run	Running
  running	Running
dveqth01n	Running
ran sveen ml1es	Running
Long Ran	Running
elliptical	Running
exhausted	Running
Running	Running
Olnn Ran	Running
ran seveB mi1se	Running
jog	Running
R ^ nnihN	Running
rtaco	Running
URNN (Nf	Running
track running	Running
RUNNING	Running
Run	Running
ran	Running
track	Running
long run	Running
e8ha8hetd	Running
easier hurt so bad	Running
ran seven miles	Running
decathlon	Running
sprinted	Running
jo9	Running
ran and walked	Running
8dadi1ftD	Dead lifts
liketd	Dead lifts
barbell deadlifts	Dead lifts
weHrft8	Dead lifts
lifted	Dead lifts
wieghts	Dead lifts
weight lifting	Dead lifts
lifting	Dead lifts
deadlift	Dead lifts
< iftde	Dead lifts
deadlifted	Dead lifts
Beh1gts	Dead lifts
wie9T2T	Dead lifts
weight i19finN	Dead lifts
lfjted wei9ht8	Dead lifts
weights	Dead lifts
dead lift	Dead lifts
deadlifts	Dead lifts
lifted weights	Dead lifts
tl1ti6g	Dead lifts
bar6e1l Sead; ifst	Dead lifts
k1fted	Dead lifts
barbell squats	Squats
SQUATS	Squats
8qTqs	Squats
Squat	Squats
Sq & at	Squats
sqtz8	Squats
medicine ball .	Squats
Al Slpit Qsuat 8 / 8id @	Squats
rettle suqatQ	Squats
6ack sauast	Squats
wegihtde s & m0 squats	Squats
jomp1nF squat oprgram	Squats
maxed out	Squats
weighted sumo squats	Squats
lifted	Squats
DB squats	Squats
suJu qsuats	Squats
Eqoatt @ d	Squats
squatted	Squats
Al Split Squat 8 / side	Squats
kettle squats	Squats
j Tmoing 8quat prgroam	Squats
sqats	Squats
jumping squat program	Squats
Doqats	Squats
sSotas	Squats
squat	Squats
6akc squatX	Squats
Squats	Squats
Al Split Squta 8 / 8idW	Squats
Ahxed out	Squats
sumo q8uays	Squats
osmK squats	Squats
squats	Squats
kettle bell swings	Squats
sumo squats	Squats
leg workout	Squats
back squats	Squats
Al 8pKti Squat 8 / side	Squats
iwe9hted sumo squatD	Squats
curled a barbell	Bicep Curl
ARM DEREGI8 $ S	Bicep Curl
chksl	Bicep Curl
ARM EXERCISES	Bicep Curl
6iFep culrs with dumbbells	Bicep Curl
kpeachke xurls	Bicep Curl
LfgIlng dombe1ls	Bicep Curl
ARM XErWCISEE	Bicep Curl
bicep crold	Bicep Curl
Fciep	Bicep Curl
duKb6e1Si	Bicep Curl
arm	Bicep Curl
lifted arms	Bicep Curl
lifted	Bicep Curl
dumbbells	Bicep Curl
Lifting dumbells	Bicep Curl
bicpe cur /	Bicep Curl
cruled a 6Ar6Wll	Bicep Curl
kajs	Bicep Curl
lifting	Bicep Curl
Lifted	Bicep Curl
Dumbbell curls	Bicep Curl
pekwhce1 curls	Bicep Curl
bicep curls with dumbbells	Bicep Curl
arms	Bicep Curl
i6cfp	Bicep Curl
kwms	Bicep Curl
dumbell curls	Bicep Curl
1if6de	Bicep Curl
bicep curls	Bicep Curl
bicep curl	Bicep Curl
preacher curls	Bicep Curl
6idcp	Bicep Curl
ARM EXEgCISsW	Bicep Curl
weights	Bicep Curl
bicep	Bicep Curl
dumbbell curls	Bicep Curl
arm 8ruls	Bicep Curl
curls	Bicep Curl
c6lr8	Bicep Curl
arm curls	Bicep Curl
udjbbwl18	Bicep Curl
curled	Bicep Curl
LiTted	Bicep Curl
JOGGING	Bicycling
cycling	Bicycling
stationary cycle	Bicycling
bicycled	Bicycling
spin	Bicycling
bike ride	Bicycling
0jg1fn9	Bicycling
biking	Bicycling
rode bike	Bicycling
8tati0neky blek	Bicycling
yoga	Bicycling
spinning	Bicycling
intervals	Bicycling
indoor bike	Bicycling
stationery bike	Bicycling
recumbent bike	Bicycling
intek2VeL	Bicycling
bicycle	Bicycling
Spin Bike	Bicycling
hi9h intensity spgi workout	Bicycling
Running	Bicycling
spin class	Bicycling
high intensity spin workout	Bicycling
rode my bike	Bicycling
bicycling	Bicycling
riding my recumbent bike	Bicycling
rode a bicycle	Bicycling
jogging	Bicycling
Cycling	Bicycling
stationary bicycle	Bicycling
cyclic	Bicycling
stationary bike	Bicycling
GVYL1Ny	Bicycling
ride	Bicycling
ddoe my bike	Bicycling
bike	Bicycling
Biking	Bicycling
CYCLING	Bicycling
exercise bike	Bicycling
ran	Bicycling
rode	Bicycling
biked	Bicycling
cycled	Bicycling
rode a bike	Bicycling
cycling class	Bicycling
GcyKihN	Bicycling
spin bike	Bicycling
rode my bicycle	Bicycling
Bynnis	Tennis
tennis match	Tennis
playcB	Tennis
Table tennis	Tennis
tennis	Tennis
tenni8 jathc	Tennis
Tabe1 tengis	Tennis
played	Tennis
chest work out	Push ups
push ups	Push ups
u0sh op	Push ups
, iftiCj	Push ups
peUh - ups	Push ups
push - ups	Push ups
upsM op	Push ups
Pduh - up	Push ups
p ^ 8h ups	Push ups
  push - ups	Push ups
lifting	Push ups
psjh up8	Push ups
jP8h ups	Push ups
PUSH UPS	Push ups
p & sh op	Push ups
  push ups	Push ups
push - up	Push ups
jumping jacks	Push ups
Hdest work 0ut	Push ups
) ush up	Push ups
pushups for chest	Push ups
Push up	Push ups
Pushups	Push ups
Push - up	Push ups
put8 ups	Push ups
push up	Push ups
pushups	Push ups
p Tsh ups	Push ups
l61itnY	Push ups
p 8 sh up	Push ups
cadki )	Walking
wL2k	Walking
WALKED	Walking
treadmill	Walking
Walking	Walking
push ups	Walking
incline walking	Walking
power - walked	Walking
speed walking	Walking
tkeand (ll	Walking
WALK1jT	Walking
Walk	Walking
8peed - wlzked	Walking
speed - walked	Walking
brisk walk	Walking
Ykeamj0ll	Walking
aw1med	Walking
cardio	Walking
walked	Walking
wak14d	Walking
walking	Walking
walk	Walking
w @ giht machines	Walking
ww1ekd	Walking
power walked	Walking
dLAK	Walking
wei9ht maXhnisr	Walking
W2KL	Walking
opxh ups	Walking
Walked	Walking
WArKED	Walking
fasR aw1ked	Walking
treadmill workout	Walking
WAL8kD	Walking
fast walk	Walking
WAL. ED	Walking
fast walked	Walking
incline 2w1Iung	Walking
waiked	Walking
WALKING	Walking
steps	Walking
WALK	Walking
awl1ed	Walking
Speed walking	Walking
warm up	Walking
walks	Walking
weight machines	Walking
fast qalrde	Walking
elilp7fca;	Elliptical Machine
e / IirPiacl machine	Elliptical Machine
eliptical	Elliptical Machine
Pwin class	Elliptical Machine
el> pil1ca1 cardio	Elliptical Machine
1e0lifiac1	Elliptical Machine
stepper	Elliptical Machine
elliptical	Elliptical Machine
elliptic	Elliptical Machine
spin class	Elliptical Machine
Elliptical	Elliptical Machine
8yrej9th	Elliptical Machine
cross trainer	Elliptical Machine
elliptical cardio	Elliptical Machine
1kpitidal	Elliptical Machine
sipG c1ass	Elliptical Machine
elliptical machine	Elliptical Machine
elipitical	Elliptical Machine
ran	Elliptical Machine
e11pitjx	Elliptical Machine
el1oipbcX1	Elliptical Machine
Strength	Elliptical Machine
st # ppe%	Elliptical Machine
leli (gJcal	Elliptical Machine
worked my back muscles	Weights, general
eegiht machine8	Weights, general
bench press	Weights, general
incline barbell press	Weights, general
weight machine	Weights, general
barbell class	Weights, general
free - weight	Weights, general
arm wrestled	Weights, general
lifted	Weights, general
upper body workout	Weights, general
lifting weights	Weights, general
dumbbells	Weights, general
dumb bell exercise	Weights, general
hand grip pulls	Weights, general
icn1nie barbell prSss	Weights, general
wei9th machiHWs	Weights, general
shoulder press	Weights, general
weight lifting	Weights, general
lifting	Weights, general
snatches	Weights, general
hip thrusts	Weights, general
lifts	Weights, general
culs	Weights, general
leg press	Weights, general
Lifting weights	Weights, general
weight training	Weights, general
free weight exercises	Weights, general
presses	Weights, general
lifted legs	Weights, general
w39i1htiRti6g	Weights, general
i1Tted	Weights, general
> iftO9n	Weights, general
kettlebell	Weights, general
weight	Weights, general
barbell rows	Weights, general
upper b0dy w * rOout	Weights, general
upper body weightlifting	Weights, general
dmub be1l ecerciQe	Weights, general
becnh ptes8	Weights, general
weights	Weights, general
squats	Weights, general
weightlifting	Weights, general
lift weights	Weights, general
lifted weights	Weights, general
weight lifted	Weights, general
lift hand weights	Weights, general
free weights	Weights, general
weight machines	Weights, general
a6s wi5ktou	Abdominal Crunches
push ups	Abdominal Crunches
istu (s	Abdominal Crunches
crunches	Abdominal Crunches
8it up	Abdominal Crunches
sit - ops	Abdominal Crunches
stomach crunches	Abdominal Crunches
pKhs up8	Abdominal Crunches
Ab workout	Abdominal Crunches
ab crunches	Abdominal Crunches
sit - ups	Abdominal Crunches
ab croGc8be	Abdominal Crunches
abs workout	Abdominal Crunches
abs roattp19	Abdominal Crunches
abs k0atbino	Abdominal Crunches
cf6Uhce8	Abdominal Crunches
abs rotation	Abdominal Crunches
ab workout	Abdominal Crunches
sit op	Abdominal Crunches
sit up	Abdominal Crunches
sit ups	Abdominal Crunches
ab	Abdominal Crunches
xknocdhs	Abdominal Crunches
sltpos	Abdominal Crunches
russian twists	Abdominal Crunches
a6	Abdominal Crunches
abs qko0lut	Abdominal Crunches
situps	Abdominal Crunches
crosfit	Interval Training
icrcuti ttaininN	Interval Training
ckiocit tra8ninV	Interval Training
hiit class	Interval Training
circuit training	Interval Training
hiit lcSss	Interval Training
hItreEa1 workouts	Interval Training
hi9t inetsnity training	Interval Training
high intensity interval taidnon9	Interval Training
HIIT training	Interval Training
HIIT	Interval Training
intense cardio	Interval Training
intervals	Interval Training
H (IT	Interval Training
high intensity training	Interval Training
interval workouts	Interval Training
bodyweight plyometric circuit	Interval Training
cr * qift	Interval Training
HI1H workout	Interval Training
high intensity interval training	Interval Training
ntiense cakdii	Interval Training
cikcoit trAiinnR	Interval Training
hi9h intensity interval 3tainNog	Interval Training
insanity workout	Interval Training
HIIT workout	Interval Training
HIIT woD, 0ut	Interval Training
suicides	Interval Training
hi9h intensity traihOng	Interval Training
Lsuh ops	Bench press
bench - press	Bench press
push ups	Bench press
bench press	Bench press
bench presses	Bench press
iifti6n	Bench press
E6Mch press	Bench press
chest workout	Bench press
CHEST WORKOUT	Bench press
1ifRde	Bench press
dumbbell bench press	Bench press
Efcline ebnch pres8	Bench press
chest volume	Bench press
lifted	Bench press
lifting weights	Bench press
Brnch rpes8e8	Bench press
dumbe11 bench prsss	Bench press
dumbbell pressed	Bench press
chest presses	Bench press
bench pressing	Bench press
lifting	Bench press
36Hhced	Bench press
military presses	Bench press
Bench presses	Bench press
benchpressed	Bench press
Bench press	Bench press
chest press	Bench press
liftsE wei9ht8	Bench press
dumbell bench press	Bench press
Bench pressing	Bench press
benched	Bench press
W # iyGts	Bench press
BenHs pres8	Bench press
EeOt9h8	Bench press
dumbell chest presses	Bench press
decline 6ench 9ress	Bench press
bench pressed	Bench press
Weights	Bench press
dips	Bench press
qie9tha	Bench press
weightlifting	Bench press
vhe8t woroktu	Bench press
W8tith8	Bench press
decline bench press	Bench press
Bench Press	Bench press
lifted weights	Bench press
6ench preWsinv	Bench press
Bnech presses	Bench press
stretches	Yoga
hot yoga	Yoga
breathing exercise	Yoga
booty yoga	Yoga
Vinyasa yoga	Yoga
h0t yoga clzAs	Yoga
d8lnawkd dog	Yoga
exerciese bike	Yoga
yoga routine	Yoga
hot yoFa cals8	Yoga
yoga workout	Yoga
EaGer	Yoga
emdiat (8n	Yoga
yoga	Yoga
flow yoga class	Yoga
50ga ivdeo	Yoga
Adho Mukho Svanasana	Yoga
Yoga	Yoga
yoga exercise	Yoga
flow yyDa class	Yoga
oy9a viveo	Yoga
yuga clsaA	Yoga
A6Fre	Yoga
mediation	Yoga
exreciees birs	Yoga
Barre	Yoga
hot yoga class	Yoga
yoga session	Yoga
downward facing dog	Yoga
booty yCpa	Yoga
downward fxicng d0g	Yoga
suryanamaskar	Yoga
Og9a video	Yoga
TdkeRch8e	Yoga
yoga video	Yoga
uyga vidro	Yoga
uyga fideo	Yoga
Dsho Mukho 8vana8ana	Yoga
Ad0h Mujho Svanasana	Yoga
yoa9% outinS	Yoga
downward afcimg d0g	Yoga
fluw yLga lcass	Yoga
heated yoga	Yoga
yoga class	Yoga
core yoga	Yoga
rlwo yoga c1ass	Yoga
downward dog	Yoga
o6oty Uoga	Yoga
bounced	Aerobics
aerobic	Aerobics
vancek - csie	Aerobics
step class	Aerobics
aeru6ics vdiSo	Aerobics
jump rope routine	Aerobics
se8p aerobics	Aerobics
yoga	Aerobics
water areobics	Aerobics
aeko6ic dacnd	Aerobics
6o ntXed	Aerobics
akeiFci	Aerobics
8etp claEs	Aerobics
AudioShield	Aerobics
Danecr - c & se	Aerobics
sgep raeo6ic8	Aerobics
c1adio	Aerobics
cardio	Aerobics
stretching	Aerobics
Zumba	Aerobics
8tEd8ThOgn	Aerobics
Dancer - cise	Aerobics
nompde rope	Aerobics
danc0w	Aerobics
8rt0RcihG9	Aerobics
skipped	Aerobics
a8nced	Aerobics
carW0i	Aerobics
aater akeubics	Aerobics
danced	Aerobics
hSep c1ass	Aerobics
aerobics video	Aerobics
eakov@sc	Aerobics
aerocbis v * deo	Aerobics
step aerobics	Aerobics
aerobics	Aerobics
aerobics class	Aerobics
Aerobic	Aerobics
Endurance	Aerobics
jump rope u8utOen	Aerobics
jumped rope	Aerobics
aerobic dance	Aerobics
ZotmaHd exekci8es	Sit Ups
8t0mach zEerFiess	Sit Ups
ck * jchse	Sit Ups
8it up	Sit Ups
crunches	Sit Ups
Sit op	Sit Ups
did	Sit Ups
buttrtelj 8it - ups	Sit Ups
sit - ups	Sit Ups
sltosp	Sit Ups
stomach exercises	Sit Ups
abs workout	Sit Ups
stiul8	Sit Ups
Sit up	Sit Ups
ab workout	Sit Ups
butterfly sit - ups	Sit Ups
sit ups	Sit Ups
sit up	Sit Ups
Sit ups	Sit Ups
abs wror1th	Sit Ups
squats	Sit Ups
8it ups	Sit Ups
ab uwrMOit	Sit Ups
8itusl	Sit Ups
butt2rf, y sit - ups	Sit Ups
situps	Sit Ups
played golf	Golf
plaGed 9lof	Golf
palyed golk	Golf
golf	Golf
GOLF	Golf
pPayed golf	Golf
run	Jogging
JOGGING	Jogging
cycling	Jogging
treadmill	Jogging
JOGGED	Jogging
JOb1CVn	Jogging
tFedaJi11	Jogging
cc8i1Gg	Jogging
kan	Jogging
Ran	Jogging
ojgEed	Jogging
J0Nr9in	Jogging
Jogging	Jogging
jugged	Jogging
jug	Jogging
jogged	Jogging
JOG	Jogging
running	Jogging
warmup	Jogging
Ygl9i9n	Jogging
cyc1iny	Jogging
jog9df	Jogging
jog	Jogging
jogging	Jogging
JOCIGvE	Jogging
Jogged	Jogging
JROGBD	Jogging
JOC	Jogging
JDFCINF	Jogging
ran	Jogging
tdrdam0l1	Jogging
jo9	Jogging
yoga	Stretching
stretches	Stretching
stretching	Stretching
yuAb	Stretching
stretched	Stretching
wt8kYhci9n stretches	Stretching
sdteGrhe8	Stretching
Body Groove	Stretching
O6dy GrooCe	Stretching
touxheV my tose	Stretching
touched my toes	Stretching
stre ^ cB8e	Stretching
Stretching stretches	Stretching
8kteyvhde	Stretching
calf raises	Other
rows	Other
netball game	Other
Cheer	Other
hills	Other
parallel bar dips	Other
racquetball	Other
cleaned	Other
balance beam	Other
video workout	Other
handball	Other
shoulder workout	Other
Wii Fit	Other
raked	Other
jupm * gg	Other
balance 6eja	Other
stretched	Other
wheelchair	Other
workout video	Other
resistance band walks	Other
sled pushes	Other
callenetics	Other
shoulder press	Other
wukkout veieo	Other
snowshoed	Other
surfing	Other
Rqhc1ky	Other
wall sits	Other
Functional Training	Other
gardening	Other
stationary bike	Other
strength training	Other
swiss ball hamstring curl	Other
farmer walks	Other
obstacle course	Other
squat thrusts	Other
archery	Other
beat saber	Other
Hydrogymnastics	Other
free hand	Other
ab roller	Other
jumping	Other
barre	Other
hooped	Other
softball	Other
jumped	Other
warm up	Other
  hopped	Other
poLk aekubics	Water Aerobics
pool aerobics	Water Aerobics
step workout	Exercise Class
dZnoG9n	Exercise Class
psin 6iie	Exercise Class
8pni b7ke	Exercise Class
dancing	Exercise Class
barre class	Exercise Class
muscle pump class	Exercise Class
ba% ke class	Exercise Class
group barre class	Exercise Class
spinning	Exercise Class
PziCnni9	Exercise Class
Sacn (ng	Exercise Class
sp (n class	Exercise Class
Nikr wokkuut	Exercise Class
pilates	Exercise Class
spin class	Exercise Class
8pij biek	Exercise Class
cardio	Exercise Class
8etp work9uF	Exercise Class
stretching	Exercise Class
Jazzercize	Exercise Class
Curves circuit	Exercise Class
dance class	Exercise Class
caric0	Exercise Class
Nike workout	Exercise Class
atketcnL9n	Exercise Class
s (in class	Exercise Class
sp0n lcass	Exercise Class
tzep worroot	Exercise Class
barre	Exercise Class
hip - hop dance class	Exercise Class
spiB i6ke	Exercise Class
spin bike	Exercise Class
segp wokrout	Exercise Class
pilates class	Pilates
ballet boot camp	Pilates
Pilates	Pilates
thigh toning pilates	Pilates
hti9h tKning pilates	Pilates
thigh tuHnig pilates	Pilates
thigh toning gi1atex	Pilates
P1iTxD8	Pilates
pilates	Pilates
pia1t8e c. ass	Pilates
birde	Hiking
hiBi	Hiking
hir @ s	Hiking
WEIG4h L1FT	Hiking
Hiked	Hiking
rhked	Hiking
walked	Hiking
  hiking trial	Hiking
Qlared	Hiking
hell hike	Hiking
walk	Hiking
hiked	Hiking
hike	Hiking
hik $	Hiking
WEIGHT LIFT	Hiking
Nier	Hiking
hikes	Hiking
hierX	Hiking
BASKET BALL	Basketball
basketball game	Basketball
BAdKOETAUL	Basketball
played basketball	Basketball
shooting	Basketball
p1ayed bSzkteNa; l	Basketball
xh8OETAELL	Basketball
EQKwrtba11	Basketball
Basketball	Basketball
BA8KET ZbLL	Basketball
BASKETBALL	Basketball
BASKBT BAPl	Basketball
bXkset bal1	Basketball
baskey 6all	Basketball
basketball	Basketball
basket ball	Basketball
played	Basketball
p1ayse basketball	Basketball
played soccer	Soccer
0sVcer	Soccer
pf0tAgl1	Soccer
f80at6lO	Soccer
football	Soccer
soccer	Soccer
swimming laps	Swimming
SWAM	Swimming
pool	Swimming
swimming	Swimming
swmiimng> aps	Swimming
esom	Swimming
: aps	Swimming
Swam	Swimming
swum	Swimming
swi <m @ d	Swimming
( o0l	Swimming
Swimming	Swimming
8wni	Swimming
p0kl	Swimming
8wna	Swimming
swim	Swimming
wsoh	Swimming
swam	Swimming
W8Jm	Swimming
swimmed	Swimming
81MA	Swimming
laps	Swimming
8w & m	Swimming
Swim	Swimming
s <ip	Skipping
skipping	Skipping
m8ip	Skipping
SKIPPING	Skipping
skip	Skipping
8. ip	Skipping
ri8plkng	Skipping
Skipping	Skipping
skip roped	Skipping
sUpi	Skipping
jumping jack	Jumping Jacks
skipping	Jumping Jacks
ojmpes	Jumping Jacks
JUMPING JACK	Jumping Jacks
sriLrpB	Jumping Jacks
8koip8e	Jumping Jacks
Jo <p * ng jacsk	Jumping Jacks
skipped	Jumping Jacks
nmop	Jumping Jacks
jump	Jumping Jacks
JUMPING JAK8	Jumping Jacks
jMjped	Jumping Jacks
Jumping jacks	Jumping Jacks
jumped	Jumping Jacks
Jumping jaKf8	Jumping Jacks
jumping jacks	Jumping Jacks
kkaaGe	Martial Arts
karate	Martial Arts
jio - jitue	Martial Arts
akra8e	Martial Arts
jiu - ijtCu	Martial Arts
jiu - jitsu	Martial Arts
hit	Martial Arts
jiu - Iytsu	Martial Arts
lightsaber techniques	Martial Arts
kickboxing	Martial Arts
ikcrrBAU9n	Martial Arts
boxed	Martial Arts
PUCHING	Bodyweight exercises, general
butterflys	Bodyweight exercises, general
bench presses	Bodyweight exercises, general
i1ft2d	Bodyweight exercises, general
butterDl% w	Bodyweight exercises, general
exercise ivdDu	Bodyweight exercises, general
sest 0f kconhces and (ush ups	Bodyweight exercises, general
wPrekd 0ut	Bodyweight exercises, general
worked	Bodyweight exercises, general
qR9etchni9	Bodyweight exercises, general
  body weight dips	Bodyweight exercises, general
lifted	Bodyweight exercises, general
jompin9 yacks	Bodyweight exercises, general
cmets dip	Bodyweight exercises, general
did ten sext	Bodyweight exercises, general
weight lifting	Bodyweight exercises, general
jompin9 Iakcs	Bodyweight exercises, general
stretching	Bodyweight exercises, general
weijgt 1iftin9	Bodyweight exercises, general
worreC	Bodyweight exercises, general
exercise video	Bodyweight exercises, general
jumping jacks	Bodyweight exercises, general
did ten sets	Bodyweight exercises, general
wukrfd out	Bodyweight exercises, general
worked out	Bodyweight exercises, general
leg lifts	Bodyweight exercises, general
sets of crunches and push ups	Bodyweight exercises, general
e6nch preQwes	Bodyweight exercises, general
chest dip	Bodyweight exercises, general
rowing machine	Bodyweight exercises, general
tCest dip	Bodyweight exercises, general
@ x2cries videu	Bodyweight exercises, general
Wet8 of rcucnhes and push ups	Bodyweight exercises, general
strength machines	Bodyweight exercises, general
belly dancing	Dancing
danc09g	Dancing
Zumba class	Dancing
ohlQ hoop dance	Dancing
husl hoop dance	Dancing
hola Muop dance	Dancing
a8jcni9	Dancing
ballet class	Dancing
choreography	Dancing
ch0k4uffapyh	Dancing
adhci9h	Dancing
dacn @	Dancing
dancing	Dancing
tap dancing	Dancing
danced	Dancing
dance	Dancing
hola hoop dance	Dancing
dnaceW	Dancing
pIarn	Planking
p1Zkn	Planking
Planks	Planking
plank ups	Planking
straight - arm plank	Planking
static plank hold	Planking
planks	Planking
plank	Planking
high plank	Planking
pw1nks	Planking
flesib7> ity tairning	Planking
8tatic plank hPdl	Planking
pKnadKd	Planking
flexibility training	Planking
p1Xkn	Planking
floor plank	Planking
planked	Planking
fleZibip7ty tkiainn9	Planking
plak9 ups	Planking
Paljrs	Planking
Ubtt B0gkout	Lunges
lunged	Lunges
lunges	Lunges
le9 ulMges	Lunges
reverse lunges	Lunges
leg uln9ec	Lunges
walking lunges	Lunges
Lunges	Lunges
. ungse	Lunges
l1ngde	Lunges
walklhg lung8e	Lunges
Butt workout	Lunges
Bitt wokk0ut	Lunges
split squats	Lunges
leg lunges	Lunges
! aIking lnuges	Lunges
Tsairv> imbinY	Stair Climbing
stPd8	Stair Climbing
stair master	Stair Climbing
step machine	Stair Climbing
stairs	Stair Climbing
stair climber	Stair Climbing
stairmaster	Stair Climbing
cilmebd qtaiks	Stair Climbing
s% ep8	Stair Climbing
c1im6ed ySairs	Stair Climbing
Stairclimbing	Stair Climbing
1icm6ed stSirs	Stair Climbing
stair - cilbmer HacBine	Stair Climbing
c1i6ehx	Stair Climbing
climbed stairs	Stair Climbing
Stairclimber	Stair Climbing
stair machine	Stair Climbing
stair - climber machine	Stair Climbing
climb	Stair Climbing
sta * k clmibre	Stair Climbing
stakjs	Stair Climbing
atpe machine	Stair Climbing
steps	Stair Climbing
1icH6fd	Stair Climbing
climbed	Stair Climbing
tsair macmiEe	Stair Climbing
skiied	Skiing
skifB	Skiing
skied	Skiing
s <iide	Skiing
xihnph8	Chin ups
chin - ups	Chin ups
chnr up	Chin ups
chns - ups	Chin ups
cihn ^ pq	Chin ups
chin up	Chin ups
chinups	Chin ups
pull ups	Chin ups
piayde	American Football
fo) btalI	American Football
football	American Football
Foot ball	American Football
PLAYED FOOTBALL	American Football
tuoch f0 (tVall	American Football
tuucg ofotabll	American Football
Tupt6lla	American Football
touch football	American Football
played	American Football
wa? red	Power walking
fast walk	Power walking
walked	Power walking
treadmill	Power walking
opwer! alked	Power walking
wakled 6Eisk1T	Power walking
power walked	Power walking
walked briskly	Power walking
afst wW1k	Power walking
wal> ed	Power walking
Volleyball	Volleyball
volley ball	Volleyball
Folley a6ll	Volleyball
vo? ley 6all	Volleyball
volleyball	Volleyball
0fl1yfHla1	Volleyball
badmitton	Badminton
badoMtt0M	Badminton
badminton	Badminton
pa1yed badKint8n	Badminton
played bamfin $ on	Badminton
played badminton	Badminton
treadmil	Treadmill
ran	Treadmill
walked	Treadmill
treadmill	Treadmill
jo9 on the rtsdami; l	Treadmill
Trddam (l1	Treadmill
Treadmill	Treadmill
walk	Treadmill
w1aM	Treadmill
kan	Treadmill
Ran	Treadmill
jog on the treadmill	Treadmill
% redalMl	Treadmill
Rhawdmi1	Treadmill
Tkwed <ill	Treadmill
TwrEdmil.	Treadmill
rows	Rowing
Odw8	Rowing
rDwde	Rowing
row machine	Rowing
rowing machine	Rowing
koaW	Rowing
rowing	Rowing
kwis	Rowing
row	Rowing
row ANchien	Rowing
rowed	Rowing
ruiwHg	Rowing
Banecd	Zumba
Zumba Gold Class	Zumba
dance fitness	Zumba
zumba	Zumba
Zumba	Zumba
cardio d8cne	Zumba
ckadio daHce	Zumba
Zumba class	Zumba
Zomab claXs	Zumba
Zjoba	Zumba
2jbma	Zumba
dancfe	Zumba
OzmbS	Zumba
cakwio adnce	Zumba
cardio dance workout	Zumba
danced	Zumba
zumba class	Zumba
cardio dance	Zumba
kicbkxonig cla8a	Kickboxing
kicmbocigg 1cass	Kickboxing
carid) ricrboxin9	Kickboxing
kick boxing	Kickboxing
Vakdio kikcobxign	Kickboxing
IIGK - BOXNIG	Kickboxing
kickboxing class	Kickboxing
kick - boxing class	Kickboxing
maDRial ar8t	Kickboxing
iicrb0xJkN	Kickboxing
martial arts	Kickboxing
BxuiBg	Kickboxing
cardio kickboxing	Kickboxing
kickboxing	Kickboxing
KICK - BOXING	Kickboxing
Eoxigh	Kickboxing
Kickboxing	Kickboxing
Boxing	Kickboxing
K8P1Pfx	Pull ups
Pull ups	Pull ups
pull - ups	Pull ups
UPLO - OP	Pull ups
Pull Ups	Pull ups
PuoL up8	Pull ups
pull ups	Pull ups
pJ1l ups	Pull ups
p16l1sp	Pull ups
Pu, l Ups	Pull ups
pullups	Pull ups
PULL - UP	Pull ups
8pll = ops	Pull ups
p1jl = ups	Pull ups
flexed arm hang	Pull ups
pull up	Pull ups
f1exed arm hNxg	Pull ups
SKIPPED	Pull ups
pull = ups	Pull ups
UpDl ups	Pull ups
CRICKET	Cricket
OFicetr	Cricket
fkci> et	Cricket
cricket	Cricket
stepped	Cardio
yIo6tud	Cardio
step class	Cardio
cardio dvd	Cardio
step climber	Cardio
kan	Cardio
HIT class	Cardio
boo ^ cmap	Cardio
Wetpkpd	Cardio
low im1cat	Cardio
bout cam )	Cardio
Fl1iipkacD	Cardio
yo ^ gbue	Cardio
Rebounding	Cardio
# xercisS ibre	Cardio
elliptical	Cardio
ezekcJ8e biek	Cardio
youtube	Cardio
tsep vlom6ek	Cardio
cardio	Cardio
Zumba	Cardio
Guot acmp	Cardio
walked	Cardio
RPM class	Cardio
HIT Skrrtoo	Cardio
exercise bike	Cardio
ran	Cardio
  HIT workout	Cardio
low impact	Cardio
conditioned	Cardio
RPM c. ass	Cardio
boot camp	Cardio
HIT c1xas	Cardio
awlrWd	Cardio
H1T clwAs	Cardio
cnodi ^ ioHZd	Cardio
burpees	Burpees
bungee jumps	Burpees
o6r0iqe	Burpees
bkoL3es	Burpees
gym	Burpees
bnugee juhp8	Burpees
burpies	Burpees
b trpEs8	Burpees
9ym	Burpees
My second exercise was intense	Burpees
H Tpkees	Burpees
burpee	Burpees
orck f1im6wd	Rock climbing
c? imblgn	Rock climbing
climbing	Rock climbing
rock climbed	Rock climbing
racquet ball	Squash
kacqKFt abll	Squash
thrusters	Crossfit
CrossFit	Crossfit
Rcos8SfG	Crossfit
u9ll - ops puhs - ups 8qua6s	Crossfit
Crossfit	Crossfit
circuit	Crossfit
cickJht	Crossfit
pull - ups push - ups squats	Crossfit
Crosgs (t	Crossfit
ifCcoti	Crossfit
raJZkin9	Kayaking
kayaked	Kayaking
kayaking	Kayaking
aryraKnH	Kayaking
push ups and dumbless workout	Dumbbells
upper body workout dumbbells	Dumbbells
lFotnib wei9ht8	Dumbbells
1ifyed weitghs	Dumbbells
1ifted 25 pLund dumbeblsl	Dumbbells
dumbbell squats	Dumbbells
duheb11c	Dumbbells
pujs ups and dumbless workout	Dumbbells
dumb bell	Dumbbells
tk9ecp extensions	Dumbbells
lifted	Dumbbells
lifting weights	Dumbbells
dumbbells	Dumbbells
lifted 28 plund dumbblesl	Dumbbells
upsh ups and dumbkeWs workout	Dumbbells
shoulder press	Dumbbells
SUMBLE <SQOATS	Dumbbells
opper body owrokut dumbg2lls	Dumbbells
DUMBELL SQUATS	Dumbbells
push ups and dum61ess rqolout	Dumbbells
lifted 25 pound dumbbells	Dumbbells
1Kfted 25 pound dubmbells	Dumbbells
cj1red	Dumbbells
tricep extensions	Dumbbells
upsh ups and dumbless w0Dkiot	Dumbbells
dumbell squats	Dumbbells
squats	Dumbbells
colrfd	Dumbbells
dubmell squaF8	Dumbbells
lifted weights	Dumbbells
curled	Dumbbells
dumbells	Dumbbells
voot 6all	Sports, general
foot ball	Sports, general
table tennis	Table tennis
ta6, e tnenis	Table tennis
h8bttep game	Table tennis
shuttle game	Table tennis
ju <p 0rpe	Jumping rope
jump ropes	Jumping rope
mJhpi69	Jumping rope
jumped	Jumping rope
jumping	Jumping rope
Umoped	Jumping rope
PUSHUPS	Jumping rope
jump0d	Jumping rope
jmup kKpe	Jumping rope
jump - roped	Jumping rope
jump rope	Jumping rope
jum0de rope	Jumping rope
ojm8niH	Jumping rope
jumped rope	Jumping rope
leg extensions	Leg press
leg press	Leg press
Le9) erss	Leg press
Leg press	Leg press
lifted	Leg press
leg presses	Leg press
le9 fpess	Leg press
leg pr 8 wsse	Leg press
leg	Leg press
leg pr @ sex8	Leg press
leg prkss	Leg press
strength - training machines	Leg press
le9 pr4ss	Leg press
1eg	Leg press
skated	Roller skating
ruoler sktaed	Roller skating
8skted	Roller skating
roller skated	Roller skating
pitched	Baseball
6ae8nial	Baseball
11tcehE	Baseball
baseball	Baseball
floor exercise	Mountain climbers
mountain climbers	Mountain climbers
moon $ aib cliembrs	Mountain climbers
Lboor exekci8e	Mountain climbers
calf raises	Leg Raises
leg lifts	Leg Raises
leg Aeise8	Leg Raises
le9 lifcT	Leg Raises
  leg lifts	Leg Raises
leg raises	Leg Raises
calf kasifs	Leg Raises
1eg rasieA	Leg Raises
curls	Leg curls
cu # l8	Leg curls
boxing class	Boxing
foxni9	Boxing
boxing	Boxing
boAi9n class	Boxing
6oxwe	Boxing
boxed	Boxing
ice skqetd	Ice skating
ice skated	Ice skating
weigth f1yq	Weight Flies
weight flys	Weight Flies
kan	Housework
Tadkenn79	Housework
ran	Housework
gardening	Housework
