plank ups	planking
flexibility training	planking
straight - arm plank	planking
floor plank	planking
planks	planking
high plank	planking
planked	planking
treadmill and stair master	walking
cardio	walking
speed walking	walking
push ups	walking
walking	walking
power - walked	walking
treadmill workout	walking
incline walking	walking
walkling	walking
weight machines	walking
brisk walk	walking
walk	walking
walked up	walking
warm up	walking
speed - walked	walking
walks	walking
speed walked	walking
power walked	walking
walked	walking
yoga exercise	yoga
flow yoga class	yoga
heated yoga	yoga
kapalbharti	yoga
yoga routine	yoga
swimming	yoga
hot yoga class	yoga
booty yoga	yoga
yoga workout	yoga
mediation	yoga
stretches	yoga
core yoga	yoga
downward facing dog	yoga
chair yoga	yoga
exerciese bike	yoga
yoga class	yoga
breathing exercise	yoga
barre	yoga
yoga	yoga
yoga session	yoga
hot yoga	yoga
downward dog	yoga
hiked	hiking
hikes	hiking
hell hike	hiking
walk	hiking
  hiking trial	hiking
nature hike	hiking
walked	hiking
hiking	hiking
ran seven miles	running
ran	running
exhausted	running
jog	running
jogged	running
track	running
hitt cardio	running
elliptical	running
ran and walked	running
sprints	running
morning run	running
better performance than my first workout	running
running	running
sprinted	running
run	running
running in place	running
  run	running
  running	running
easier hurt so bad	running
ran uphill	running
long run	running
ran sprints	running
ran	jogging
jogging	jogging
jog	jogging
running	jogging
treadmill	jogging
jogged	jogging
i went running	jogging
jugged	jogging
run	jogging
sit - ups	jogging
muscle pump class	exercise class
cardio	exercise class
spin bike	exercise class
group barre class	exercise class
hip - hop dance class	exercise class
spin workout	exercise class
zumba dance	exercise class
barre class	exercise class
curves circuit	exercise class
water aerobics class	exercise class
jazzercize	exercise class
workout video	exercise class
dancing	exercise class
barre	exercise class
spinning	exercise class
zumba dance class	exercise class
step workout	exercise class
spin class	exercise class
intervals	bicycling
rode bikes	bicycling
exercise bike	bicycling
rode bike	bicycling
ride	bicycling
spin cycle	bicycling
ran	bicycling
ride my bicycle	bicycling
rode a bike	bicycling
stationary cycle	bicycling
bike ride	bicycling
cycled	bicycling
rode my bike	bicycling
bicycled	bicycling
rode my bicycle	bicycling
cycling	bicycling
rode	bicycling
bike	bicycling
bicycling	bicycling
jogging	bicycling
running	bicycling
cyclic	bicycling
bikeriding	bicycling
rode mtn bike	bicycling
high intensity spin workout	bicycling
indoor bike	bicycling
spinning	bicycling
yoga	bicycling
riding my recumbent bike	bicycling
bicycle	bicycling
pedaled	bicycling
recumbent bike	bicycling
recumbent bicycle	bicycling
spin class	bicycling
biking	bicycling
biked	bicycling
hit workout	interval training
circuit training	interval training
intervals	interval training
high intensity interval training	interval training
hiit class	interval training
suicides	interval training
hiit	interval training
bodyweight plyometric circuit	interval training
hiit workout	interval training
intense cardio	interval training
high intensity training	interval training
circuit	interval training
insanity workout	interval training
high intensity interval workout	interval training
dance fitness	zumba
zumba gold class	zumba
zumba class	zumba
cardio dance workout	zumba
zumba	zumba
danced	zumba
rebounding	cardio
cardio	cardio
conditioned	cardio
exercise bike	cardio
ran	cardio
  hit workout	cardio
step class	cardio
elliptical	cardio
jumped	cardio
yogasanam	cardio
cardio dvd	cardio
rpm class	cardio
zumba	cardio
boot camp	cardio
youtube	cardio
step climber	cardio
walked	cardio
low impact	cardio
ran	elliptical machine
elipitical	elliptical machine
strength	elliptical machine
cross trainer	elliptical machine
elliptical	elliptical machine
elliptical cardio	elliptical machine
spin class	elliptical machine
elliptic	elliptical machine
stepper	elliptical machine
jog on the treadmill	treadmill
walk	treadmill
treadmill	treadmill
finished	treadmill
walked	treadmill
treadmill walk	treadmill
weight - lifting	bench press
push ups	bench press
bench presses	bench press
benched	bench press
bnech presses	bench press
weightlifting	bench press
lifting weights	bench press
dumbbell bench	bench press
bench pressed	bench press
lifted	bench press
lifting	bench press
bench - press	bench press
decline bench press	bench press
dumbbell pressed	bench press
chest press	bench press
benchpressed	bench press
bench press	bench press
lifted weights	bench press
chest volume	bench press
dumbell chest presses	bench press
basket ball	basketball
basketball	basketball
played basketball	basketball
played	basketball
basketball game	basketball
sumo squats	squats
weighted sumo squats	squats
back squats	squats
leg workout	squats
squat hold	squats
squatted	squats
maxed out	squats
sqats	squats
barbell squats	squats
squat	squats
al split squat 8 / side	squats
squats	squats
jumping squat program	squats
leg day set of lifts	squats
dumbell squats	squats
medicine ball .	squats
lifting	push ups
push ups	push ups
jumping jacks	push ups
pushups for chest	push ups
  push - ups	push ups
  push ups	push ups
push - up	push ups
pushups	push ups
push up	push ups
dancing	dancing
zumba class	dancing
ballet class	dancing
hola hoop dance	dancing
choreography	dancing
belly dancing	dancing
danced	dancing
weights	chest press
dumbell bench press	chest press
push ups	chest press
incline press	chest press
chest press	chest press
weightlifting	chest press
bench press	chest press
chest presses	chest press
push up	chest press
leg press	leg press
strength - training machines	leg press
leg	leg press
leg presses	leg press
leg extensions	leg press
golf	golf
played golf	golf
lifted legs	weights, general
dumb bell exercise	weights, general
presses	weights, general
kettlebell	weights, general
weights	weights, general
incline barbell press	weights, general
lift hand weights	weights, general
one - armed rows	weights, general
weightlifting	weights, general
lifting weights	weights, general
squats	weights, general
as i performed barbell squats i felt like quitting .	weights, general
weight machines	weights, general
weight training	weights, general
lifted	weights, general
barbell class	weights, general
hand grip pulls	weights, general
lifting	weights, general
upper body weightlifting	weights, general
deadlifts	weights, general
free - weight	weights, general
strength training	weights, general
culs	weights, general
bench press	weights, general
dumbbells	weights, general
free weight exercises	weights, general
weight trained	weights, general
lifted weights	weights, general
upper body workout	weights, general
barbell rows	weights, general
free weights	weights, general
lift weights	weights, general
weight lifting	weights, general
deadlifted	weights, general
weight lifted	weights, general
shoulder press	weights, general
weight	weights, general
abs workout	abdominal crunches
abs rotation	abdominal crunches
russian twists	abdominal crunches
abdominal workout	abdominal crunches
ab machine	abdominal crunches
bicycle crunches	abdominal crunches
ab	abdominal crunches
stomach crunches	abdominal crunches
crunches	abdominal crunches
core strength exercises	abdominal crunches
ab crunches	abdominal crunches
sit up	abdominal crunches
sit - ups	abdominal crunches
situps	abdominal crunches
arms	bicep curl
arm curls	bicep curl
curls	bicep curl
weights	bicep curl
dumbell curls	bicep curl
bicep curls	bicep curl
lifted	bicep curl
lifting	bicep curl
curled	bicep curl
preacher curls	bicep curl
dumbbells	bicep curl
bicep curls with dumbbells	bicep curl
arm workout	bicep curl
lifted arms	bicep curl
bicep curl	bicep curl
arm exercises	bicep curl
dumbbell raises	bicep curl
dumbbell curls	bicep curl
pilates class	pilates
pilates	pilates
thigh toning pilates	pilates
butterfly sit - ups	sit ups
abs workout	sit ups
ab workout	sit ups
  jog	sit ups
stomach exercises	sit ups
crunches	sit ups
sittups	sit ups
squats	sit ups
sit up	sit ups
sit - ups	sit ups
situps	sit ups
skipped	jumping jacks
jump rope	jumping jacks
jumping jacks	jumping jacks
jump	jumping jacks
jumping jack	jumping jacks
skipping	jumping jacks
dumb bell	dumbbells
curled	dumbbells
lifted 25 pound dumbbells	dumbbells
push ups and dumbless workout	dumbbells
squats	dumbbells
standing dumbbell press	dumbbells
dumbells	dumbbells
lifting weights	dumbbells
upper body workout dumbbells	dumbbells
dumbbells	dumbbells
dumbbell rows	dumbbells
shoulder press	dumbbells
dumbell squats	dumbbells
tricep extensions	dumbbells
row machine	rowing
rowing machine	rowing
row	rowing
rowed	rowing
rower	rowing
rows	rowing
gardening	housework
cleaning	housework
weight lifting	crossfit
crossfit	crossfit
circuit	crossfit
pull - ups push - ups squats	crossfit
hiit class	crossfit
climbing	rock climbing
rock climbed	rock climbing
pool	swimming
swam	swimming
swimming laps	swimming
ran	swimming
swimming	swimming
laps	swimming
swimmed	swimming
kick boxing	kickboxing
boxing	kickboxing
cardio kickboxing	kickboxing
kick - boxing	kickboxing
kickboxing class	kickboxing
martial arts	kickboxing
hit	kickboxing
step aerobics	aerobics
aerobics video	aerobics
zumba classes	aerobics
step class	aerobics
skipped	aerobics
aerobics class	aerobics
jumped rope	aerobics
zumba	aerobics
danced	aerobics
workout video	aerobics
bounced	aerobics
jump roped	aerobics
aerobics	aerobics
jump rope routine	aerobics
aerobic dance	aerobics
yoga	aerobics
endurance	aerobics
dancer - cise	aerobics
water areobics	aerobics
volleyball	volleyball
burpees	burpees
gym	burpees
bungee jumps	burpees
burpee	burpees
like lifting weights and burpees	burpees
my second exercise was intense	burpees
stairclimbing	stair climbing
stair master	stair climbing
stair stepping	stair climbing
stair climber	stair climbing
climbed	stair climbing
step machine	stair climbing
climbed stairs	stair climbing
stairs	stair climbing
steps	stair climbing
climb	stair climbing
stair - climber machine	stair climbing
stairclimb	stair climbing
dribble	soccer
indoor soccer	soccer
soccer	soccer
played soccer	soccer
leg raises	leg raises
  leg lifts	leg raises
calf raises	leg raises
table tennis	tennis
tennis game	tennis
tennis	tennis
tennis match	tennis
pull = ups	pull ups
pull ups	pull ups
skipped	pull ups
flexed arm hang	pull ups
pull - ups	pull ups
pull up	pull ups
push up	pull ups
shuttle game	table tennis
stretching stretches	stretching
stretching	stretching
yoga	stretching
stretched	stretching
exercise	stretching
body groove	stretching
touched my toes	stretching
pull ups	chin ups
chin up	chin ups
chin - ups	chin ups
chinups	chin ups
barbell deadlifts	dead lifts
weights	dead lifts
weight lifting	dead lifts
deadlifts	dead lifts
romanian deadlifts	dead lifts
wieghts	dead lifts
deadlifted	dead lifts
dead lifts	dead lifts
deadlift	dead lifts
dead lift	dead lifts
mountain climbers	mountain climbers
stationary bike	other
wheelchair	other
racquetball	other
cleaned	other
balance beam	other
bowling	other
high knees	other
raked	other
upper arm exercises	other
stretched	other
hydrogymnastics	other
beat saber	other
warmup	other
obstacle course	other
ab roller	other
swiss ball hamstring curl	other
functional training	other
strength training	other
shoulder workout	other
parallel bar dips	other
sled pushes	other
video workout	other
workout video	other
jumping	other
warm up	other
resistance band walks	other
barre	other
free hand	other
wii fit	other
shoulder press	other
gardening	other
walked briskly	power walking
treadmill	power walking
fast walk	power walking
power walked	power walking
walked	power walking
cross country skiing	skiing
skiied	skiing
boxing	boxing
boxed	boxing
skip	skipping
skipping	skipping
flys	weight flies
jumped	jumping rope
jump - roped	jumping rope
jump rope	jumping rope
jump ropes	jumping rope
jumped rope	jumping rope
pushups	jumping rope
walking lunges	lunges
lunges	lunges
lunged	lunges
butt workout	lunges
weighted lunges	lunges
reverse lunges	lunges
weights	bodyweight exercises, general
did ten sets	bodyweight exercises, general
strength machines	bodyweight exercises, general
weight lifting	bodyweight exercises, general
rowing machine	bodyweight exercises, general
stretching	bodyweight exercises, general
  body weight dips	bodyweight exercises, general
butterflys	bodyweight exercises, general
free body and weighted exercises	bodyweight exercises, general
puching	bodyweight exercises, general
pool aerobics	water aerobics
karate	martial arts
jiu - jitsu	martial arts
boxed	martial arts
lightsaber techniques	martial arts
taekwondo	martial arts
hit	martial arts
foot ball	american football
played football	american football
played	american football
touch football	american football
badminton	badminton
played badminton	badminton
bench presses	body weight exercises, general
jumping jacks	body weight exercises, general
sets of crunches and push ups	body weight exercises, general
leg lifts	body weight exercises, general
chest dip	body weight exercises, general
worked	body weight exercises, general
cricket game	cricket
squash	squash
kayaked	kayaking
paddled	kayaking
foot ball	sports, general
rollerblading	roller skating
skated	roller skating
baseball	baseball
curls	leg curls
ice skating	ice skating
