Hot but I worked through the weather on my run	run	Running
started with warm up which is running . my blood circulation reached all my muscles and there wre less chances of getting injured	running	Running
My second workout was running and just running nothing else .   My legs were sore but still I loved it	Running	Running
I AM RUNNING THREE MILES I FEEL VERY DIFFICULT IN THE FIRST WOROUT	RUNNING	Running
I ran a 3.5 mile loop , most of which was on a crushed cinder track . I was very tired , but felt strong during the last half mile .	ran	Running
I went for a long run I was tired but psyched that I got out to do something .	run	Running
I ran on the treadmill for 5 minutes . I 'm breathing hard and feel like I 'm out of shape .	treadmill	Running
I ran 1.5 miles I felt tired	ran	Running
I ran three miles . I felt so out of breath !	ran	Running
I ran 4 miles on the treadmill and it was hard .	ran	Running
I ran for 20 minutes and felt exhausted .	ran	Running
I ran one mile outside . I felt ok until later when my plantar fasciitis made it hard to walk .	ran	Running
I ran ten miles . I was really tired !	ran	Running
i ran 5 miles   tired but felt good	ran	Running
I ran on a treadmill for five minutes .   My legs feel really weak .	ran	Running
I went for a run for about two miles . It was exhausting but it was good for a bit	run	Running
I ran on the treadmill for 30 minutes . I felt determined and strong . I made sure to start out slowly and slowly go faster so I would n't tire myself out . I felt relaxed yet active and accomplished at the same time .	Ran	Running
I would run on the treadmill for 30 minutes . I felt energized .	  run	Running
I ran two miles . I feel refreshed .	ran	Running
I ran 2 miles on the treadmill . I am exhausted and really out of shape !	ran	Running
I ran for 60 minutes straight . It felt so good !	ran	Running
I ran for 30 minutes around my neighborhood It was horrible because it was very hilly .	ran	Running
I ran 4 miles on the bike trail .   I felt a little sluggish today and kept a slower pace but glad to get it done .	ran	Running
I ran a 7 minute mile . I felt spent and exhausted afterwards .	ran	Running
I just ran a 5k race ! I feel good but exhausted .	ran	Running
I ran seven miles and I felt full of energy .	ran seven miles	Running
I just ran a 100 meter race . I can not feel my legs .	ran	Running
I like to run on a treadmill I feel energized and fit	run	Running
I just ran two miles . I 'm really exhausted !	ran	Running
I went for a run on the treadmill . I was super out of breath .	run	Running
i went running and i felt great afterwards	running	Running
I Have Early Morning Go to Running . I Am Very Energetic On The Day .	Running	Running
I just ran for 10 minutes . My heart felt like it was going to beat itself out of my chest .	ran	Running
I ran 5 miles and was exhausted but I felt great .	ran	Running
i was running   during and after the performance i felt very heavy and tired	running	Running
ran three miles   terrible	ran	Running
I ran three miles . I feel energetic .	ran	Running
I just ran a half mile . I felt very winded .	ran	Running
I aimed for better performance than my first workout .   I felt around the same as I did after my first workout .	better performance than my first workout	Running
I run around my neighbor hood every morning .   After my run , I feel out of breath because there are a lot of hills .	run	Running
I just ran for thirty minutes . I felt energized and active .	ran	Running
I ran three miles I felt amazing after the run	ran	Running
I just did a ten kilometer run . I feel wiped out and ready to collapse on the floor .  	run	Running
I ran for two miles on a treadmill It was great !	ran	Running
I ran on the treadmill for 60 minutes . I ca n't believe how weak I feel in the knees .	ran	Running
I ran on a treadmill I felt tired	ran	Running
Running in an area you know Tired but productive	Running	Running
I ran two kilometers today My whole body aches	ran	Running
I went running for 25 minutes . I am out of shape .	running	Running
I ran 1 mile I felt exhausted	ran	Running
I ran five miles . I felt energized .	ran	Running
I ran three miles outside . It went great other than the pain I now feel in my knees .	ran	Running
I tried to run a 10k I felt exhausted , I used to be in much better shape	run	Running
I ran for 30 minutes It feels exhilarating	ran	Running
I ran on the treadmill for 1 hour . I was exhausted and my clothes were drenched with sweat .	ran	Running
I ran 2 miles and felt like my lungs were on fire	ran	Running
10 mile run . I felt tired .	run	Running
I did ten 20 meter sprints I felt nauseous	sprints	Running
I then run for an hour and afterwards feel exhausted .	run	Running
I ran three miles on uphill track I felt exhausted at the end	ran	Running
I ran on the treadmill for 30 minutes   I felt great the first 10 minutes but the last 30 were miserable	ran	Running
I went to the high school track and then i ran four miles After i was done i felt exahusted , but was happy with myself .	ran	Running
I ran outside I felt much better	ran	Running
I ran five miles . I felt really strong and proud of myself .	ran	Running
I ran a long run of two and a quarter hours I felt OK today . I had a rough patch around the hour mark	ran	Running
i ran a 5k it was terrifying	ran	Running
I ran for 30 minutes I felt exhausted	ran	Running
I just finish my 40 minutes running . I am very thirsty .	running	Running
I played one hour of RingFit Adventure on Nintendo Switch with the workout ring running in place and performing arm exercises I was very engaged and challenged and had a lot of fun while sweating and breathing hard	running	Running
I just did ran a half mile . I feel like I might die .	ran	Running
I ran a mile It was great	ran	Running
I just finished running 2 miles . It was a lot harder than I expected . I 'm sore .	running	Running
track running i feel very good	track running	Running
Running , 5 miles . 7:15 pace . 67 degrees . Felt fast	Running	Running
I ran three laps around the block .   I felt really good with a racing heart and alot of sweat .	ran	Running
I ran laps for twenty minutes . I was out of breath .	ran	Running
I ran one mile and felt dead tired afterwords .	ran	Running
I ran half of a mile .   My legs were numb and tingly and i felt accomplished	ran	Running
ran a mile and tired	ran	Running
I ran for 30 minutes around my neighborhood . I was extremely exhausted .	ran	Running
my first workout was running few miles that s so hard to me	running	Running
I ran a mile . I felt healthy .	ran	Running
I ran for 10 minutes . I 'm dying .	ran	Running
I spend one hour working out at different levels on an elliptical .   I was entertained by YouTube during the workout .	elliptical	Running
I just ran 8 laps around the park and I feel extremely exhausted !	ran	Running
I ran 1 mile on the treadmill I should run more	ran	Running
I ran three miles on the track , it was painful . I felt like shit	ran	Running
I ran around the lake .   Tired and winded	ran	Running
I just ran up 30 flights of stairs . I feel wiped out .	ran	Running
I ran two miles with my dog ! The dog ran better than I did , I 'm so tired , I need to start doing this more often !	ran	Running
i tried to run i could n't make it	run	Running
i just ran about a mile it was hard but rewarding	ran	Running
I ran 5 times around the track and felt sore .	Ran	Running
I just ran 3 miles up hill . I was feeling so out of shape , I could hardly breathe !	ran	Running
I ran two miles on a treadmill I was really out of breath and felt exhausted and sweaty .	ran	Running
I ran on the elliptical and got my blood pumping !	ran	Running
I ran 2 miles on the treadmill   My body was exhasuted and I have a headache	ran	Running
i just ran i am exhausted	ran	Running
I ran 50 minutes and I felt better and energized .	ran	Running
ran two miles   terrible	ran	Running
I ran around the block one time I felt exhausted and tired after running	ran	Running
I ran 5 miles . I felt so exhausted .	ran	Running
I ran for a hour I felt very tired .	ran	Running
I just ran 5 miles around the track . I realize that I am out of shape .	ran	Running
i ran six miles i was very out of breath	ran	Running
Ran 4 miles good time , could have ran more	Ran	Running
I ran for 4 miles today ! I felt like I had a lot of endurance while running .	ran	Running
I ran 3 miles .   I was bored after the first mile .	ran	Running
I ran on the treadmill for 5 miles . I felt exhausted !	ran	Running
i just ran five kilometers on the track very energitic	ran	Running
I go for a 30 minute run .   I feel exhausted but content .	run	Running
I ran 3 miles today . My run was long and hard .	ran	Running
I ran on the treadmill for 45 minutes and I feel good	ran	Running
Ran 3.5 miles of hills at Torrey Pines Legs feel good , but lungs are tired	Ran	Running
I ran 2 laps I felt exhilarated !	ran	Running
I ran 1 mile outside I 'm breathless from running	ran	Running
I ran on the trail for 30 minutes . I was tired , out of breath , and sweaty !	ran	Running
I just ran 1.5 miles on the treadmill .   I was starting to cramp after the mile mark .	ran	Running
I ran 5 miles on an indoor track My right knee is sore	ran	Running
just ran two miles very tired	ran	Running
I ran 2 miles on the treadmill today . I was really tired and out of breath afterwards .	ran	Running
Super long run around the lake at the local park Super tired after the long run , but being out in nature felt great	long run	Running
I just ran a mile . I felt really tired and short of breath .	ran	Running
I ran two miles . I felt energized .	ran	Running
I ran five miles . I feel energized .	ran	Running
I just ran 3 miles today . I feel accomplished but exhausted .	ran	Running
I just ran a mile on the treadmill I feel tired afterwards .	ran	Running
I ran 5 km along the beach and I felt exhausted	ran	Running
I did My Usual first set of the workout aka my run   i felt good adrenaline and feel like i need to do this more often	run	Running
I warmed up by running I felt tired in the beginning but then picked it up afterwards .	running	Running
I ran two miles . I felt very exhausted .	ran	Running
doing running feel better	running	Running
I ran a mile in 10 minutes . I am feeling pumped !	ran	Running
I ran on the treadmill for 5 minutes and felt exhausted .	treadmill	Running
I ran for 30 minutes on the treadmill . winded and out of breath	ran	Running
I ran doe two miles . I felt really tired after my run anf my feet really hurt	ran	Running
I ran 10 miles and I felt refreshed !	ran	Running
Ran today Feel good	Ran	Running
I just ran a mile .   I feel tired .	ran	Running
I ran 2 miles .   I feel so energetic .	ran	Running
I ran on the treadmill for 2 miles without stopping at all to walk . I felt like my cardio was good , but I was tired out too .	ran	Running
I ran 5 K today , outside and as fast as I can . I 'm sweating like crazy , my body temperature feels higher than normal .	ran	Running
ran 3 miles exhausted	ran	Running
I just ran a 5k . I hope I do n't have shin splints !	ran	Running
I went outside and ran one mile . I felt really exhausted since I am out of shape .	ran	Running
I ran 6 miles . I feel accomplished .	ran	Running
I ran 5 K on the treadmill this afternoon . I feel invigorated !	ran	Running
I ran 8 km and i felt fresh afterwards	ran	Running
I ran on the treadmill for 40 minutes   I felt exhausted and depleted	ran	Running
I ran for 4 and a half miles today . I was exhausted after the run but felt great .	ran	Running
I ran on the treadmill for an hour today . My legs feel like they are about to fall off .	ran	Running
I ran and walked two miles on the treadmill . I felt tired and bored .	ran and walked	Running
i just ran 200metres and am so stressed out	ran	Running
I ran for ten minutes and felt out of shape	ran	Running
I ran 4 miles at the gym on the treadmill . I feel good right now .	ran	Running
I just ran 2 miles . I m super psyched for the day .	ran	Running
I ran a mile , I felt pretty good afterward . Much more energetic .	ran	Running
I just ran three miles It was terrible	ran	Running
I ran 1 mile on the treadmill . I felt exhilerated during my run .	ran	Running
I   ran on the treadmill today   I felt tired after performing this workout .	ran	Running
I ran for 30 minutes . I felt fast .	ran	Running
I ran 30 minutes on the treadmill I felt exhausted .	ran	Running
Running 4 miles I felt like my knees were numb with sharp pain	Running	Running
I went on a 30 minute jog i felt tired	jog	Running
I ran five miles and felt energized .	ran	Running
I ran four miles . I felt in tip top shape .	ran	Running
I ran a half marathon i felt exhausted	ran	Running
I ran for a mile and a half . I felt exhausted and need to catch my breath .	ran	Running
I ran the treadmill for 30 minutes and I feel exhausted	ran	Running
I ran on the treadmill for 30 minutes . I felt invigorated .	ran	Running
I ran and felt winded	ran	Running
I ran a 10k on a river levee . I felt happy after completing the 10k !	ran	Running
Running at Park My body is very active .	Running	Running
I ran for an hour . I felt euphoric .	ran	Running
I ran 4 miles today . It was a hard 4 miles I was dragging all the way through .	ran	Running
I ran 5 km and it felt great .	ran	Running
I run about a mile .   I feel like i m dying .	run	Running
I ran on a treadmill for 1 hour . I was so tired and bored after my workout .	ran	Running
I ran a Ultra Beast Spartan Race and felt like I was going to die	ran	Running
I finished my morning run I feel good and energetic	morning run	Running
I ran a marathon I am exhausted	ran	Running
My first workout was an outside run . I felt tired during my run from yesterday 's exercise .	run	Running
i did a 20mins running on a spot i felt tired	  running	Running
i running at the morning five miles . then i feel energized .	running	Running
I ran 4 mile reps at 6:15 to 6:30 pace First mile felt easy last mile I felt fatigued after the first 800 meters	ran	Running
I ran 2.5 miles in twenty minutes this morning I feel parched and tired	ran	Running
I ran for 30 minutes on the treamill . I am exhausted now .	ran	Running
I just ran 2 miles . I'm exhausted now .	ran	Running
I ran on the treadmill for 30 minutes . My calves are killing me .	ran	Running
I just ran nonstop for 3 miles . I feel very accomplished now !	ran	Running
I ran 3 miles today . It was amazing run the sun was shining and my legs were just moving on there own !	ran	Running
I went for a run I felt alright	run	Running
I ran for 30 minutes I felt tired in the beginning but energized in the end	ran	Running
I ran two miles on the treadmill . I am out of breath , sweaty and need to drink something ,	ran	Running
I went running for an hr I felt energized	running	Running
I ran 5 kilometres outside . I felt refreshed after I finished .	ran	Running
running in the street I felt exhausted	running	Running
Just completed a 3 mile run . I feel awful !	run	Running
I ran 2 football fields . I feel good and energized .	ran	Running
I ran uphill with a friend and the next day , my heels and calfs were killing me from soreness	ran uphill	Running
I ran a mile and a half It was tough	ran	Running
I ran for 5 minutes . It was awful !	ran	Running
I ran 2 miles on the treadmill I felt exhausted afterwards	ran	Running
I ran 1 mile yesterday I felt nice doing it	ran	Running
I ran for 1 mile and felt energized afterwards	ran	Running
I ran for two miles . My legs are shaky but I feel good .	ran	Running
I ran 3 miles . I feel drained .	ran	Running
I just ran 3 miles on the river trail . I felt great because the air was fresh .	ran	Running
I ran two miles yesterday I was sweating profusely but felt great afterwards .	ran	Running
I ran with my girlfriend this afternnon I am very out of shape compared to my girlfriend	ran	Running
i ran for 2 hours on a treadmil i am happy but very tired and my legs really hurt	ran	Running
I just ran 2 miles ! I felt great , very energetic	ran	Running
3 Mile Run Feet sore , very fatigued .	Run	Running
I ran around the block . I felt happy afterwards .	ran	Running
I ran for 10 minutes feeling dizzy	ran	Running
I ran for one minute I felt Great !	ran	Running
I just ran for 5 minutes straight .   I 'm out of breath .	ran	Running
I just ran for 30 minutes on the treadmill . The joint in my toe is still a little tender .	ran	Running
I ran a mile . I feel awful .	ran	Running
I just ran a mile on the treadmill . I feel out of breath .	ran	Running
I ran six miles . I felt terrific .	ran	Running
I just ran two miles   I feel invigorated	ran	Running
I went for a short run . I feel gross , I do n't like running !	run	Running
I ran a mile on the treadmill I felt so out of shape	ran	Running
I ran for an hr I felt refreshed	ran	Running
I ran 3 miles I felt so tired	ran	Running
I ran 2 miles on the track and i feel great	ran	Running
I ran 6 miles with my best friend . I felt very tired , as my friend is faster than me , so its not easy to run his pace .	ran	Running
I ran on the treadmill I felt tired after	ran	Running
I ran 3 miles .   Out of breath the first half mile , then felt good .	ran	Running
I ran 15 miles .   I feel exhausted .	ran	Running
running at early   morning gives good energy	running	Running
I ran a 9 mile race today . It felt good .	ran	Running
I just ran a mile Sick to my stomach	ran	Running
I ran one mile on the treadmill   I felt energized	ran	Running
Ran for 10 minutes straight at the local gym I felt Tire after the running	Ran	Running
I ran two miles on the sidewalk today .    I felt good and strong , nice and easy .  	ran	Running
I just ran up and down the stairs 30 times ! I feel so tired !	ran	Running
I ran on the treadmill for 45 minutes straight I felt really tired but happy	ran	Running
I ran on the treadmill .   I feel motivated .	ran	Running
FIRST WORK OUT RUNNING I AM HARD TO WORK OUT	RUNNING	Running
I ran for a few blocks . I was exhausted .	ran	Running
I ran to my parents house about a mile away I felt out of shape and winded	ran	Running
This one was far easier but my legs hurt so bad   Still felt proud after completion but really tiring during	easier hurt so bad	Running
I just ran 4 miles on the track . I feel exhausted .	ran	Running
I ran sprints up the hills by the field exhausted	ran sprints	Running
i ran one mile i felt tired but accomplished	ran	Running
I ran four miles on the treadmill at the gym . I felt exhausted and pushed to my limit .	ran	Running
ran 2 miles i felt energized	ran	Running
I ran a 5k I felt healthy	ran	Running
I ran six miles I felt GREAT afterwards ! But now , I really need some water .	ran	Running
I just ran 5 miles I feel totally exhausted	ran	Running
I tried to run 3.5 miles in the humidity , yesterday . I felt like I was running in soup and couldn't catch my breath .	run	Running
I ran 2 miles I felt refreshed	ran	Running
I ran on the treadmill today . I felt exhausted after running .	ran	Running
I ran 5 miles on a treadmill I felt tired	ran	Running
I ran 5 kilometers on the treadmill this evening . I felt very satisfied .	ran	Running
Long Ran around three miles on Track I feel it was very tough	Long Ran	Running
I ran on the treadmill for a hour I felt really tired after .	ran	Running
I AM RUNNING IN FIRST WORKOUT FIRST WORKOUT DIFFICULT	RUNNING	Running
I ran in the park 2 miles this morning I felt a little tired from the lack of exercise	ran	Running
I ran 5 miles today in town . My pace was terrible .	ran	Running
I am so exhausted after that workout   I felt proud after I completed the workout	exhausted	Running
I ran 10 miles . I am exhausted .	ran	Running
running feel better	running	Running
I just ran two miles on the track . I was extremely tired after this workout .	ran	Running
i feel tired , i just ran three miles .	ran	Running
I just ran 2 miles I am absolutely drained	ran	Running
I ran 3 miles on a treadmill . I felt rejuvenated after working out .	ran	Running
ran on the treadmill very tired but feel energized	ran	Running
I ran to the lake and back . I felt a nice runner's high .	ran	Running
I went on a run I felt exhausted physically	run	Running
I ran for 45 minutes on the treadmill . I felt so tired and out of shape .	ran	Running
I ran fifteen miles . I feel winded .	ran	Running
I just ran a 5k My legs are tired now	ran	Running
I just ran a mile around the neighborhood .   My legs are very shaky .	ran	Running
I ran easy for forty five minutes Felt tired from yesterday 's workout .	ran	Running
I just ran a mile My legs feel so light	ran	Running
i ran on a treadmill for 15 minutes to reach 1 mile tired , but full of adrenaline and endorphines . sweaty but motivated !	ran	Running
I just   done my treadmill running . Ohh , I feel very tired and sweating a lot .	running	Running
I ran a mile this afternoon . It 's been a while since I ran so it took me longer than usual and I 'm beat .	ran	Running
I just ran for thirty minutes . My legs ache .	ran	Running
I ran on the treadmill for an hour . My legs are hurting so bad .	ran	Running
Today I ran 5 miles on my treadmill . I was sweaty and my feet hurt a lot .	ran	Running
I ran one mile . I felt powerful .	ran	Running
I ran for half an hour . I 'm so winded !	ran	Running
I just ran four miles I feel like I'm going to fall down	ran	Running
I ran 3 miles on the treadmil . I am so out of shape and out of breath .	ran	Running
I ran laps around the track I felt accomplished and tired	ran	Running
I ran five miles . I felt refreshed .	ran	Running
I jogged on the treadmill for 30 minutes . My legs were tied and I was sweating .	jogged	Running
i ran down to the store 3blocks away my legs feels like jello after that	ran	Running
I ran on the treadmill for 15 minutes ! that almost killed me !	ran	Running
I just ran 9 miles on the trail . My feet are a little tired , but my calves are shot !	ran	Running
i just ran around my block twice .   I was really exhauted when i got back home .	ran	Running
I went running   I was tiered	running	Running
I ran a 5k race this morning .   I was really slow since it was so hot outside .	ran	Running
I ran for an hour yesterday . My legs felt fine , I feel like I could run some more .	ran	Running
I just ran 2 miles I felt exhilarated	ran	Running
I spent the past half hour running 50-yard and 100-yard sprints I need to lose some weight because I am so winded after just 10 minutes .	sprints	Running
I ran for 20 minutes and I feel exhausted .	ran	Running
running a mile tired and happy	running	Running
Running at least 4 block up and back down . I felt really tired but worked at it again .	Running	Running
I ran five miles . I feel fit .	ran	Running
I ran six kilometers and felt tired but relaxed afterwards . My head felt clear and good , and my calves and legs felt tired but relaxed .	ran	Running
I have run 4 miles in morning . I have feel do not energized and leg pain	run	Running
I have just completed the decathlon . I felt relieved .	decathlon	Running
I ran a mile I felt very out of breath .	ran	Running
I ran 2 miles at 5 am Very energized , but really tired too	ran	Running
I just ran for an hour on the treadmill . I felt more energy and relaxed at this time .	ran	Running
I went running and I felt exhilarated .	Running	Running
I just ran four miles I feel so much energy	ran	Running
Workout : Ran 15 minutes on Treadmill .7 Miles I felt like my heart was going to explode .	Ran	Running
i ran around the track for a half hour i felt out of breath !	ran	Running
I ran 5 miles around my neighborhood . I felt tired , but grateful that my body was able to run 5 miles up and down hills .	ran	Running
I warmed - up on the treadmill for 30 minutes , and increased the treadmill speed and ran for 1.5 minute intervals with 30 second rests in between . I feel great .	ran	Running
I ran six miles I feel on top of the world	ran	Running
I ran a half marathon . I felt very tired .	ran	Running
I ran 3 miles today . I felt so exhausted1	ran	Running
i running five miles at the morning . then i feel energized .	running	Running
i ran a mile very tired	ran	Running
I ran 3.75 miles with Virginia and felt great .	Ran	Running
My second workout was running It was tiring	running	Running
i ran on the treadmill for 60 minutes   i felt very tired	ran	Running
I did HITT Cardio outdoors on the track I was exhausted	HITT Cardio	Running
I ran two miles today . It felt good to run .	ran	Running
I just sprinted a mile . I feel exhausted !	sprinted	Running
i ran five miles and i feel better energized	ran	Running
I complete a 1 hour run at 7:30 pace I felt good until the last 10 minutes so I started my warm down early .	run	Running
I ran 4 miles and I feel drained .	ran	Running
I ran one hour in treadmill .   I felt tiring .	ran	Running
I ran four miles on a country road .   I felt great .	ran	Running
Ran 5 miles on the treadmill Felt good while running , but was tired afterwards .	Ran	Running
I ran for 10 minutes on the treadmill I feel exhilarated and full of zest !	ran	Running
I ran two miles It was excellent	ran	Running
I ran on the treadmill for 15 minutes . I honestly felt like I was going to die .	ran	Running
I ran on the elliptical machine for 30 minutes . I feel great !	ran	Running
I just ran for thirty minutes on the treadmill . I feel beat .	ran	Running
30 minute run .    Harder than expected	run	Running
I just ran 6 miles ! I felt like I was dying .	ran	Running
the first thing I do is run for 3 miles after this exercise I feel accomplished , but exhausted	run	Running
Today I ran 1 mile . I feel accomplished	ran	Running
I ran 3 miles without stopping . I feel like I have conquered the world .	ran	Running
3 miles track felt poor this morning	track	Running
I deadlifted 500 lbs and I felt unstoppable !	deadlifted	Dead lifts
I just lifted weighs at the gym I 'm feeling tired but energetic and accomplished	lifted	Dead lifts
Today I went to the Gym and Lifted wieghts I felt really out shape , but felt energized after my workout	wieghts	Dead lifts
I hit a max deadlift attempt I felt exhausted after the workout	deadlift	Dead lifts
I completed 25 deadlifts . I feel really tough .	deadlifts	Dead lifts
I did weight lifting and felt much more exhausted but still strong	weight lifting	Dead lifts
I did weights today felt pumpedd	weights	Dead lifts
I deadlifted 235 pounds for 2 sets of 3 reps . I felt both overwhelmed and strong .	deadlifted	Dead lifts
i just deadlifted i feel really strong	deadlifted	Dead lifts
I lifted weights in the gym . I feel incredibly tired !	lifted weights	Dead lifts
I lifted a 300 lb deadlift for 3 reps of 5 sets   Good day for lifting , hit a new personal record and body felt good about it . Sore afterwards .	deadlift	Dead lifts
I just did some heavy weight lifting . I feel sore already .	lifting	Dead lifts
I lifted weights for 2 hours It was awesome	lifted weights	Dead lifts
I just did 5 barbell deadlifts I felt so good lifting that much	barbell deadlifts	Dead lifts
I completed six sets of deadlifts I felt exhausted after completing my sets .	deadlifts	Dead lifts
dead lift weak and began sweating	dead lift	Dead lifts
I did 10 deadlifts I felt great	deadlifts	Dead lifts
I deadlifted 200 lbs . man that hurt	deadlifted	Dead lifts
i did 15 reps of 300 lb deadlifts for the last 10 minutes . i felt powerful honestly , and full of energy . a little stressed in the knees and legs though .	deadlifts	Dead lifts
I did a max deadlift session and felt completely exhausted	deadlift	Dead lifts
I just deadlifted 200lbs ! I feel so strong !	deadlifted	Dead lifts
I deadlifted the other day and felt great .	deadlifted	Dead lifts
I focused on my form during my deadlift attempts . I felt a little better but exhausted .	deadlift	Dead lifts
I did barbell squats for an hour and felt very tired	barbell squats	Squats
I just squatted for five sets . I felt accomplished .	squatted	Squats
I did 15 squats I feel sore	squats	Squats
I squatted for the first time today . I felt exhausted after squatting .	squatted	Squats
I 'm doing squats with a medicine ball . My knees are hurting after this workout .	medicine ball .	Squats
I did squats with my bodyweight My legs are n't strong enough	squats	Squats
I just did heavy back squats . I was struggling to hit 80 % of my max .	squats	Squats
10 squats for senior citizen Felt better after first 3 squats	squats	Squats
I did 30 squats . My legs felt like noodles .	squats	Squats
I did 15 reps of sumo squats . My legs were sore after !	sumo squats	Squats
Squat Bar Speed workout one Good can get through 30 minutes of plyos	Squat	Squats
I completed 100 squats . I felt invigorated .	squats	Squats
I did squats so I can have a killer butt   My butt muscles burned but it will all be worth it later !	squats	Squats
the core exercise being low bar squats and found them extremely taxing	squats	Squats
I just did half a mile of squats .   I felt like my legs were burning !	squats	Squats
My second workout was squats I felt exhausted	squats	Squats
I did 5 sets of squats My legs felt tired	squats	Squats
I did 4 sets of squats on the squat rack My legs were shaking during the workout but afterwards I felt so energized	squats	Squats
I did sqats against the wall I felt a burn .	sqats	Squats
Squat is my second workout exercise . I felt energetic and fresh .	Squat	Squats
I did some squats . I felt good .	squats	Squats
I did 70 squats . It was tiring .	squats	Squats
I squatted 250 pounds . My legs feel shaky .	squatted	Squats
3 sets DB squats felt poor this morning	DB squats	Squats
I just squatted 300lbs for 15 reps . I felt strong but I 'm also tired now .	squatted	Squats
I had to squat 50 times   My legs feel like spaghetti	squat	Squats
I did twenty five squats . My thighs are burning .	squats	Squats
I did 30 squats . My legs are burning .	squats	Squats
I felt good and I think it was effective this Al Split Squat 8 / side	Al Split Squat 8 / side	Squats
I just did squats for the first time in weeks . My legs are absolutely dead today .	squats	Squats
I did squats It was a little rough	squats	Squats
Squats , after my excersise my legs felt they were going to fall off	Squats	Squats
I squatted for 20 minutes I was exhausted afterwards	squatted	Squats
3 sets of squat 12 reps each set My legs are trembling	squat	Squats
I just did a jumping squat program I felt like i 'm getting it more	jumping squat program	Squats
I performed 50 back squats today . My legs are really tired and sore .	back squats	Squats
My legs are burning from doing so many squats .	squats	Squats
I did 10 squats My legs felt like noodles	squats	Squats
I performed 3 sets of squats at the gym It was challenging	squats	Squats
My first workout was kettle bell swings I felt I was going to die during my kettlebell routine	kettle bell swings	Squats
I just completed 100 squats My legs are killing me	squats	Squats
I just did weighted sumo squats I felt awesome !	weighted sumo squats	Squats
I did squats . I feel sore .	squats	Squats
i did 50 squats i feel very tired and sore	squats	Squats
I just did 100 squats I felt awful	squats	Squats
I just did three sets of heavy barbell squats . I feel so sore right now !	barbell squats	Squats
I did three sets of squats . My hamstrings felt a little tight .	squats	Squats
I did 60 squats It hurt my legs	squats	Squats
I did 50 squats . I feel shaky and out of breath .	squats	Squats
I performed 20 squats with dumbells My legs are sore	squat	Squats
50 squats without stopping ! It felt invigorating !	squats	Squats
Squats Felt strength	Squats	Squats
I just did 25 kettlebell squats . My legs feel weak !	squats	Squats
I did 100 squats and felt great .	squats	Squats
I squatted 225 lbs . My hamstrings are incredibly sore and tired .	squatted	Squats
My workout was squats I felt good	squats	Squats
I just did eight sets of twelve squats . I feel tried and shaky .	squats	Squats
I squatted 3x8 . I felt strong and empowered .	squatted	Squats
I did 50 squats . My legs hurt	squats	Squats
I did squats . I felt sore .	squats	Squats
I did 60 squats in my room I felt very refreshed	squats	Squats
I lifted weights for thirty minutes . I felt good .	lifted	Squats
I did 15 squats I was exhausted .	squats	Squats
Squats I did squats and the following day my thighs were in so much pain	Squats	Squats
I did 40 squats with a 20 lb weight I felt exhausted .	squats	Squats
I did twenty squats . My butt is burning !	squats	Squats
My second workout was kettle squats I felt that my legs were going to fall off	kettle squats	Squats
I used a 20 pound barbell to squat 30 times . I was exhausted and tired and very sweaty .	squat	Squats
I just did 50 squats I hated it ! It was too much work and I am sore !	squats	Squats
squats with weights very tired after workout	squats	Squats
i did 100 air squats   i need to work more on my legs	squats	Squats
I did 50 squats My legs felt very tired	squats	Squats
I DID 5 SETS OF 25 SQUATS MY LEG MUSCLES ARE TREMBLING AND TIRED	SQUATS	Squats
I did one set of barbell squats . I felt weak .	barbell squats	Squats
One set of squats Now my legs hurt	squat	Squats
I did 20 squats It made my heart rate go up and it felt good .	squats	Squats
i just did 50 squats now my legs are shaky	squats	Squats
i did 25 squats my thighs hurted a lot	squats	Squats
I maxed out doing squats and felt like I could n't stand on my own legs	maxed out	Squats
I did a leg workout . My body is shaking .	leg workout	Squats
I did 50 squats . I felt sore in my thigh .	squats	Squats
I tried doing squats I could ' t do it proprietlu and I felt ashamed	squats	Squats
I decided to try to add squats to my routine During was no issue it was the second when it was really tough	squats	Squats
I performed 45 weighted squats , and I felt pumped up .	squats	Squats
I squatted with weights My thigh muscles feel sore	squatted	Squats
i lifted weights for an hour and a half my arms were sore	lifted	Bicep Curl
i did bicep curls it made my arms sore	bicep curls	Bicep Curl
I performed three sets of dumbbell curls . I felt amazing pushing that heavy weight .	dumbbell curls	Bicep Curl
I did arms in the gym and felt sore .	arms	Bicep Curl
I lifted weights for 30 minutes I felt pumped after	lifted	Bicep Curl
I did some preacher curls   Fantastic , my arms got a nice pump .	preacher curls	Bicep Curl
Lifted weight at the gym I felt Exhausted after lifting the weights	Lifted	Bicep Curl
I just did four sets of eighty pound curls with my curl bar . I feel obliterated and spent .	curls	Bicep Curl
i lifted weights weak and tired	lifted	Bicep Curl
Lifting 25 pound dumbells for bicep curls I felt tired , but could ve liften more	bicep curls	Bicep Curl
i did 10 sets of bicep curls    my arms are feel like they want to explode	bicep	Bicep Curl
Dumbbell curls and I felt great afterwards	Dumbbell curls	Bicep Curl
My first workout was using ten pound dumbbells and lifting them . I felt energized and wanted to do more exercising .	dumbbells	Bicep Curl
I did arm curls with 20 pounds My arms are very strong	arm curls	Bicep Curl
I lifted free weights while watching tv . I felt my muscles fatigue after a time .	lifted	Bicep Curl
I lifted weights for 30 minutes . My body is a little sore , but I feel pretty good overall .	lifted	Bicep Curl
I lifted back and biceps at home today It ws intense but fun	lifted	Bicep Curl
I just did 15 reps of arm curls . I feel vigorous .	arm curls	Bicep Curl
I 'm doing bicep curls Pumping my arms makes me feel like a strong man .	bicep curls	Bicep Curl
Lifting dumbells My arms feel tired and more energetic .	Lifting dumbells	Bicep Curl
I just did three sets of bicep curls with dumbbells . I felt strained during the workout .	bicep curls with dumbbells	Bicep Curl
i lifted 300 pounds i felt like i was having a stroke	lifted	Bicep Curl
I curled 50lbs and my arms were very sore .	curled	Bicep Curl
I used 15 pound weights to do 3 sets of arm curls my arms felt wobbly after	arm curls	Bicep Curl
I spent an hour lifting weights . I felt energized .	lifting	Bicep Curl
I just did a warm up set of lifting . It felt like burning .	lifting	Bicep Curl
I lifted weights I felt energized	lifted	Bicep Curl
I PERFORMED ARM EXERCISES TODAY MY ARM MUSCLES WERE SLIGHTLY TIRED .   	ARM EXERCISES	Bicep Curl
I did some arm exercises My arms were a little tired afterwards .	arm	Bicep Curl
I did four sets of ten reps each of bicep curls . I felt a lot of strain and it took great effort to finish .	bicep curls	Bicep Curl
I curled a barbell for three sets I felt exhausted afterwards	curled a barbell	Bicep Curl
I did three sets of dumbbell curls . My arms feel stronger .	dumbbell curls	Bicep Curl
I curled dumbells for 30 repetitions muscle fatigued	curled	Bicep Curl
i did 4 sets of bicep curls i am feeling energized	bicep curl	Bicep Curl
I did a bunch of dumbbell curls during - feel the burn after - wow my muscles feel warm	dumbbell curls	Bicep Curl
I lifted arms for an hour Good pump	lifted arms	Bicep Curl
dumbell curls it was good	dumbell curls	Bicep Curl
I lifted weights . I feel so muscular .	weights	Bicep Curl
I just cycled five miles . My legs where so strong after .	cycled	Bicycling
I biked 10 miles on a stationary bike at medium resistance . It was a low level cardio workout .	stationary bike	Bicycling
high intensity spin workout I felt very sweaty and worn out .	high intensity spin workout	Bicycling
I cycled for one hour and my legs were in so much pain after !	cycled	Bicycling
I did cyclic exercises I felt limber	cyclic	Bicycling
I rode my bike for 10 miles today on the rail trail . My muscles felt invigorated .	rode my bike	Bicycling
I biked nine miles and felt tired , but energized , and I felt confident .	biked	Bicycling
I cycled 30 miles and felt energized and healthy	cycled	Bicycling
I rode eight miles on the stationary bike . My quads are so sore right now .	stationary bike	Bicycling
I used the stationary bike for 30 minutes I felt winded in my first work out and realized I need to build up my endurance .	stationary bike	Bicycling
I rode exercise bike for one half hour I felt tired and legs were weak	exercise bike	Bicycling
I just cycled for an hour and a half . I feel exhausted !	cycled	Bicycling
i went cycling along the river i felt energized	cycling	Bicycling
I was cycling in gym . I felt relax and happy .	cycling	Bicycling
I ran 3 kilometers on the beach It was energitic	ran	Bicycling
I biked for 20 minutes My knees hurt	biked	Bicycling
I biked five miles . I feel energetic .	biked	Bicycling
I did 1 hour of spinning at home I felt very satisfied to complete the whole routine	spinning	Bicycling
Bike ride on canal , carefree	bike ride	Bicycling
I just cycling five miles . i am really out of shape	cycling	Bicycling
I rode my bike 15 miles today . It was exhausting .	bike	Bicycling
I biked 5 miles . I felt excited .	biked	Bicycling
i just biked 4 miles on the stationary bike i felt fairly good although my heart rate did n't come up too much . my rpms were less than i wanted but i did n't need to take any breaks	biked	Bicycling
i biked 10 miles my legs were sore	biked	Bicycling
I did a yoga routine . I have sore muscles I did n't know i had .	yoga	Bicycling
I rode my bike one mile . I felt like I was n't doing anything , not real exercise	bike	Bicycling
I just cycled for an hour . I felt sore after the exercise .	cycled	Bicycling
I went on a 15 mile bike ride by the beach last week .    I felt exhausted by the end .	bike ride	Bicycling
I did an hour spin class I was exhausted	spin class	Bicycling
I cycled for 10 minutes I felt it was difficult to keep going	cycled	Bicycling
I rode my bike for 10 miles   Now my legs feel numb	bike	Bicycling
I ride bike for 1 hour felt good	bike	Bicycling
I rode my bike for 3 miles . My legs were really sore afterwards .	rode	Bicycling
I spent 15 minutes on the indoor bike . I felt very drained .	indoor bike	Bicycling
I rode my bike this morning on the bike path My legs were really sore and I was winded after the bike ride	rode	Bicycling
MY FIRST WORKOUT IS JOGGING . AFTER A HOURS STILL MY BODY PAINS WHEN I NORMALLY WALK .	JOGGING	Bicycling
I just biked nine miles I feel great	biked	Bicycling
I biked 20 miles ! I was exhausted after finishing .	biked	Bicycling
I just biked for 8 miles I felt very tired	biked	Bicycling
I was only able to complete 1 mile on the stationary bike . I felt weak and like a failure because I did n't complete my goal .	stationary bike	Bicycling
I rode my bike for 10 minutes I was excited	rode	Bicycling
I just rode the bike for ten minutes . My legs hurt from the peddling	bike	Bicycling
I rode 6 miles on my bike I felt motivated	rode	Bicycling
The second workout is biking for 1 hour my legs were tired after	biking	Bicycling
I rode my bike for 2 miles today my legs were a little sore	bike	Bicycling
I rode my bike for five miles . I felt exhilarated while riding my bike .	bike	Bicycling
Mtb Biking of road in park Good balance and flow	Biking	Bicycling
I rode a bike for 2 hours . I feel exhausted .	rode a bike	Bicycling
I just rode my bike for 40 miles I felt out of shape	rode	Bicycling
Going to Running I feel very fresh .	Running	Bicycling
I rode my bike for 20 miles .   It was hard but I felt good when I finished	rode	Bicycling
I did cyclic exercises for 15 minutes I felt like my legs were more limber	cyclic	Bicycling
I took a 45-minute cycling class . it was very difficult .	cycling class	Bicycling
I bicycled for 2 miles I felt winded	bicycled	Bicycling
I rode my bicycle two miles today .   I felt exhausted when I got home .	rode	Bicycling
I rode the stationary bike for 30 minutes today . It was tough going , but no I feel great .	stationary bike	Bicycling
I just did 10 minutes on the bicycle . My legs feel good .	bicycle	Bicycling
i just went for a bike ride hungry and cold	bike ride	Bicycling
I did 30 minutes on a spin bike . I was out of breath !	spin bike	Bicycling
DOING CYCLING UP TO 10 KM AND I FEEL HIGH RATE OF HEART - BEAT .	CYCLING	Bicycling
I cycled 20 miles . I was exhausted during the ride , it had been so long since I was on a bike .	cycled	Bicycling
I rode my Spin Bike for 20 minutes . My heart is beating rapidly .	Spin Bike	Bicycling
I rode my bicycle 10 miles It was great !	bicycle	Bicycling
I rode 30 miles on my bike today .   My legs feel shaky and i am exhausted .	bike	Bicycling
I rode a stationary bike for 60 minutes . I was exhausted .	stationary bike	Bicycling
I worked on the bicycle at the gym for 30 minutes . I feel so much better because I worked up a sweat .	bicycle	Bicycling
i rode a bike in gym 7 miles i felt great	bike	Bicycling
I rode a bicycle for 30 minutes and I feel refreshed	rode	Bicycling
I rode a stationary bicycle for 30 minutes . It felt really good .	rode	Bicycling
I just rode a bike for 30 minutes My legs feel like noodles	rode a bike	Bicycling
i biked 20 miles i got tired	biked	Bicycling
I rode on my bike for 1 hour outside today . It was so nice to get fresh air and feel the cold hit my breath .	rode	Bicycling
bicycling fun and satisfied	bicycling	Bicycling
I rode my bicycle I forgot how much balance and torso control a bike needs	bicycle	Bicycling
I rode 30 minutes on a stationery bike My legs feel like jelly	stationery bike	Bicycling
I rode my bike two miles . My legs were so sore after	rode	Bicycling
I rode my bike the entire length of the shoreline trail . I felt exhausted and ready for a nap .	bike	Bicycling
biked 5 files really tired	biked	Bicycling
I spent the day working out on the exercise bike for the first time in about a year , and I woke up the net morning so sore on my legs and arms .	exercise bike	Bicycling
I just rode my bicycle seventeen miles . I feel great but it is hot outside .	rode my bicycle	Bicycling
I rode a bicycle   I felt free	bicycle	Bicycling
I just biked for 3 miles .   I really need to do this more often !	biked	Bicycling
I rode my bike for 15 minutes . I was tired and short of breath .	bike	Bicycling
I rode a bicycle for 1 hour today . I feel really tired !	rode a bicycle	Bicycling
I just did cycling for half an hour . I felt that my legs are completely out of strength .	cycling	Bicycling
I did an hour on the exercise bike this morning I was worn out after	exercise bike	Bicycling
I did 40 minutes of bicycling .   I feel tired .	bicycling	Bicycling
I biked for 20 miles today . My legs feel like jell - o .	biked	Bicycling
I did 10 miles on the exercise bike .   I feel very accomplished .	exercise bike	Bicycling
I rode the exercise bike for 40 minutes My legs feel strong	bike	Bicycling
I just did a 5 mile beach bike ! I felt invigorated and sweaty !	bike	Bicycling
I biked down the riverwalk and felt great !	biked	Bicycling
I just cycled 2 miles I felt energized	cycled	Bicycling
I rode my bike around the block .   I felt energized afterwards .	rode	Bicycling
I rode 10 miles of bike trails . I felt thirsty and tired .	rode	Bicycling
I just road a bike for 5 miles I felt good but tired	bike	Bicycling
I biked thirty minutes . I feel revitalized .	biked	Bicycling
I rode my bike today . I love riding my bike .	rode	Bicycling
i went for a bike ride felt like a kid again	ride	Bicycling
I biked thirty minutes . I felt healthy .	biked	Bicycling
I just bicycled 20 miles I feel very refreshed ! I loved it when my hair blew in the wind !	bicycled	Bicycling
biked a two miles and okay	biked	Bicycling
I just rode 15 minutes on the exercise bike . I felt sore afterward !	exercise bike	Bicycling
I biked 6 miles . I feel strong now .	biked	Bicycling
i just did 1 mile intervals on my bike i am tired and trying to catch my breath	intervals	Bicycling
I just biked 9 miles on my peloton I felt invicible !	biked	Bicycling
I cycled for 3 miles I felt refreshed after	cycled	Bicycling
I rode my bike for ten miles . I feel exhilerated .	rode	Bicycling
I just did 15 minutes on the bike . My legs are really sore !	bike	Bicycling
I cycled for half an hour .   I felt sweaty .	cycled	Bicycling
I went spinning for half an hour today I feel determined to make a habit of it	spinning	Bicycling
I just bicycled for 2 miles . My legs feel like jelly .	bicycled	Bicycling
I rode my bike and felt refreshed .	bike	Bicycling
I biked 5 miles in the neighborhood . I was so shaky and my legs felt like jello .	biked	Bicycling
rode exercise bike 30 min . for 6 miles a little tired and sweaty	exercise bike	Bicycling
Cycling for 5 miles I felt tired	Cycling	Bicycling
I attended a 45 minute spin class . I felt pumped up and had fun !	spin class	Bicycling
I work out cycling i feel very happy	cycling	Bicycling
I rode a recumbent bike for an hour . I feel exhilarated !	recumbent bike	Bicycling
I just rode my bike 10 miles on the rail trail .   My legs muscles are quivering with fatigue !	bike	Bicycling
I pedaled the stationary bike for 20 minutes .    My knees felt weak when I finished .	stationary bike	Bicycling
I rode on my bike for approximately 1 hour and felt so energetic afterwards .	bike	Bicycling
I went to a spin class .   I felt so tired !	spin class	Bicycling
i rode my bike 10 miles I feel rejuvenated	rode	Bicycling
I went to the gym and biked 4 miles on the stationary bicycle . My legs were a little shaky after done .	biked	Bicycling
Went on a 5 mile bike ride My legs are shot	ride	Bicycling
Riding a bike up a hill and coming back down . It was a little better . It wasn't that bad when trying it but it did burn .	bike	Bicycling
I did 1 hour of spinning after work I felt somewhat tired when I finished	spin	Bicycling
I used my stationary bike for an hour I 'm beat !	bike	Bicycling
I did 20 miles on my stationary cycle . I feel exhilarated .	stationary cycle	Bicycling
I just did a two mile biking class at the gym . Wow , it was hard to keep up , I need to get in shape . I am really tired !	biking	Bicycling
I biked one mile and felt tired	biked	Bicycling
I rode a bike for one hour I felt energized	bike	Bicycling
I just biked 3 miles . My legs really hurt .	biked	Bicycling
I rode the stationary bicycle for 30 minutes I felt somewhat tired .	bicycle	Bicycling
I did 30 minutes on a stationary bicycle .   My back feels nice , it really straightened out my neck .	stationary bicycle	Bicycling
I just biked 10 km ! I feel invigorated !	biked	Bicycling
I biked for 1 hour . I felt really powerful .	biked	Bicycling
I biked four miles . I feel terrific .	biked	Bicycling
I just rode my exercise bike . It felt really good and I am glad that I did this .	exercise bike	Bicycling
I did 10 minutes on the stationary bike .   I felt like my legs were jelly and were weak .	bike	Bicycling
I biked the greenway in two hours . The wind was brisk so my cheeks are numb , but it was still satisfying .	biked	Bicycling
I rode a bike for 5 miles . I felt terrible , my knees were so painful ,	bike	Bicycling
I rode my bike 10 miles I felt exhilirated when it was over .	rode	Bicycling
I exercised on an exercise bike . I felt more energetic .	exercise bike	Bicycling
I rode my bike for 20 minutes . I felt invigorated .	rode	Bicycling
I do cycling everyday I feel good	cycling	Bicycling
I bicycled four miles on the trail today . It was awesome !	bicycled	Bicycling
I rode the stationary bike for half an hour .    I fell like my legs are shaky .	rode	Bicycling
i rode a bicycle for 30 minutes   my leg ache alot	rode	Bicycling
I rode bike for three miles I felt sore in my legs	rode bike	Bicycling
I rode a stationary bike 10.55 miles twice . A little stiff and sore , but felt exuberant when I completed the rides .	rode	Bicycling
I went biking it is relaxing	biking	Bicycling
I rode the stationary bicycle for 30 minutes . I felt good , not as bad as I thought .	stationary bicycle	Bicycling
I went on a bike ride for two hours . My legs felt so weak afterward .	bike ride	Bicycling
just biked 3 miles i am sore	biked	Bicycling
I rode my bike 8 miles It was exhilerating	bike	Bicycling
I just biked 10 miles . I felt exhausted .	biked	Bicycling
I took a 20 mile bike ride on local trails my legs were sore but it was fun .	bike ride	Bicycling
rode a bicycle i 'm so out of breathe	rode	Bicycling
I rode my bike for 1 hour I felt invigorated after	bike	Bicycling
I rode the stationary bike 5 miles . I felt sweaty and out of breath .	rode	Bicycling
I rode my bike for 3 miles . Afterwards , I felt relaxed and calm .	bike	Bicycling
I cycled for 3 hours . I feel worn out !	cycled	Bicycling
I felt extremely energized after riding my recumbent bike for 30 minutes .	riding my recumbent bike	Bicycling
I bicycled to town and back . It was so tiring I think it was uphill both ways .	bicycled	Bicycling
jogging good	jogging	Bicycling
I just rode my bike ten miles . I felt winded .	bike	Bicycling
I rode my peloton bike . I felt exhausted .	bike	Bicycling
I just rode 22 miles on the bike . I am so sore I ca n't even move .	bike	Bicycling
I cycling and i get full energy of body	cycling	Bicycling
I pedaled on the exercise bike for 45 minutes my legs felt strong !	bike	Bicycling
I biked five miles . I felt terrific .	biked	Bicycling
Workout : I played tennis for 2 hours . How I felt I was tried but felt great	tennis	Tennis
I played three tennis matches and my back hurts so much right now	tennis	Tennis
I play tennis for about half an hour every day I felt very energetic	tennis	Tennis
i am played two hour tennis . I felt strong	tennis	Tennis
I played tennis for an hour . I feel invigorated .	tennis	Tennis
I played an hour of tennis . I feel exhausted .	tennis	Tennis
I love to play tennis It feels great	tennis	Tennis
I played tennis for an hour . I am not good at tennis .	tennis	Tennis
I played tennis for 2 hours . I felt very alive and happy .	tennis	Tennis
I played tennis with my dad I felt happy	tennis	Tennis
I just finished a three hour tennis match . I have never in my life felt this exhausted before !	tennis match	Tennis
I played tennis for two and a half hours . I was tired and ready for bed .	tennis	Tennis
i just played singles tennis . my knees are killing me .	tennis	Tennis
I played Table tennis game today I feel strong	Table tennis	Tennis
I played tennis at the park with a friend . I need to practice my tennis more !	tennis	Tennis
I played tennis for one hour My legs were sore	tennis	Tennis
I played tennis for 45 minutes . I feel energized but I might be sore tomorrow .	tennis	Tennis
i played three hours tennis iam really out of day	tennis	Tennis
I played tennis for two hours I felt really tired	tennis	Tennis
I played doubles tennis for 45 minutes I felt exhausted but tough .	tennis	Tennis
I played tennis with my spouse and felt great !	tennis	Tennis
I played tennis for two hours I am really tired	played	Tennis
I just played two hours of tennis .   I felt great about my game and am glad I got some exercise .	tennis	Tennis
I played tennis for an hour . I felt energized , excited , and happy .	tennis	Tennis
I just played tennis My arms are sore	tennis	Tennis
A played three hours of tennis . I felt amazing .	tennis	Tennis
  i did 20 body weight pushups   i was out of breath	pushups	Push ups
I just did 50 pushups ! I feel pumped !	pushups	Push ups
I did 20 pushups . I feel energized .	pushups	Push ups
I did 25 push ups My arms were very tired after doing the push ups	push ups	Push ups
I did 30 push ups . It was painful . I struggled to the end .	push ups	Push ups
i did 10 push ups and felt good	push ups	Push ups
I did 2 sets of 10 pushups today . Sore but good .	pushups	Push ups
I do 100 push ups .   Like my arms are strong and i could kill a bull .	push ups	Push ups
YESTERDAY I WAS WORKING OUT DOING PUSH UPS . I GOT TIRED AFTER ONLY FIFTY PUSH UPS AND QUIT BECAUSE MY MUSCLES IN MY ARMS WERE CRAMPING UP AND IT WAS HURTING .	PUSH UPS	Push ups
I did 25 pushups . My arms feel like noodles .	pushups	Push ups
push ups I felt tired	push ups	Push ups
I did three sets of twelve pushups , I am a beginner at these . I felt super out of shape .	pushups	Push ups
SECOND WORKOUT IS PUSH UPS   REALLY GOOD FEEL	PUSH UPS	Push ups
4 sets of push ups triceps sore	push ups	Push ups
I did push ups yesterday I was in pain from it	push ups	Push ups
I JUST DID 20 PUSH UPS I'M PUMPED UP AND READY FOR MORE	PUSH UPS	Push ups
I did 100 push ups I felt like my arms were on fire !	push ups	Push ups
I got on the floor and did some pushups . I felt a little tired but pushed through .	pushups	Push ups
I did 40 push ups I feel stronger .	push ups	Push ups
I just did a set of push ups . My arm muscles really feel week .	push ups	Push ups
I did 30 push ups at home I was really exhausted	push ups	Push ups
i did push ups this is hard	push ups	Push ups
I did three sets of pushups . I felt exhausted and out of shape !	pushups	Push ups
i take   100 push ups i feel so tired	push ups	Push ups
I did 20 pushups for chest I am feeling great about it !	pushups for chest	Push ups
I made 40 push - ups and i felt weak	push - ups	Push ups
I just did 50 pushups and feel exhausted .	pushups	Push ups
"""Workout : """" I did 3 sets of 15 push ups . """" How you felt : """" It was a difficult circuit , but I pushed through and now feel accomplished ! """""""	push ups	Push ups
I tried to do push ups and could only do three My arms were shaking and I felt weak	push ups	Push ups
I accomplished 20 push - ups this session .   I was pretty achy but I felt energized .	push - ups	Push ups
I did fifteen push ups i feel great	push ups	Push ups
I did a hundred push ups today My upper body aches !	push ups	Push ups
I did twenty pushups . I feel great !	pushups	Push ups
I did 30 pushups . I feel great !	pushups	Push ups
FIrst thing I do in the morning when I wake up is do 25 push - ups . It wakes me up and gets me going in the morning .	push - ups	Push ups
I did 50 pushups without a break my arms and chest burn	pushups	Push ups
i did 20 pushups this made me feel warmed up	pushups	Push ups
The first time I went for exercise I just did few push ups .   I felt really good after that workout and then decided to go to gym at least three times a week .	Pushups	Push ups
""""""" I did twenty push - up . """" """" I felt Happy . """""""	push - up	Push ups
My first workout today was a chest work out I felt amazing after my workout	chest work out	Push ups
I did push ups Envigorated	push ups	Push ups
I did twenty push ups . My muscles are sore .	push ups	Push ups
I did 100 pushups . It was awesome and feel better .	pushups	Push ups
I do push ups . I feel weak .	push ups	Push ups
I did forty push - ups . I felt strained .	push - ups	Push ups
I did a series of exercises including push - ups and sit - ups While I am glad to do it , the exercises made me tired .	push - ups	Push ups
I did 3 sets of pushups with 30 reps My chest and back of arms are sore .	pushups	Push ups
I just did 100 push ups My arms were killing me	push ups	Push ups
I did 50 pushups My arms are shaky and feel numb .	pushups	Push ups
I did some push ups I felt tired	push ups	Push ups
I made 50 push ups in a row It was exhausting	push ups	Push ups
i did 25 push ups   it   made my body feel tense	push ups	Push ups
I like to do pushups on knuckles in basement It makes you feel exhilarated in the morning .	pushups	Push ups
I just did 50 push - ups ! My arms feel like Jelly !	push - ups	Push ups
pushups exausted	pushups	Push ups
I did 8 push ups . The last few were definitely struggles .	push ups	Push ups
I just did 25 push - ups . My arms feel like jelly .	push - ups	Push ups
I did pushups against the wall . I felt challenged .	pushups	Push ups
I did 20 push ups . I was starting to warm up .	push ups	Push ups
I did 100 push ups I feel great	push ups	Push ups
10 push ups pumped ready to do a second set	push ups	Push ups
I just did 15 pushups . I feel out of shape .	pushups	Push ups
i did 50 push ups i really feel strong	  push ups	Push ups
did a set of pushups my arms are so sore	pushups	Push ups
I just did ten pushups . It felt satisfiying doing these pushups .	pushups	Push ups
I just did 2 sets of 20 push ups . I feel my arms shaking .	push ups	Push ups
i did 20 push - ups in a row i feel like i am going to die	push - ups	Push ups
Push up exercise Felt like I was going to stop breathing during the excercise	Push up	Push ups
I did pushups at the park . My arms are sore but I feel accomplished .	pushups	Push ups
I did forty pushups . I felt strained .	pushups	Push ups
I just 5 sets of push ups . My arms feel like jello .	push ups	Push ups
i just di 100 push ups i felt really stronger	  push ups	Push ups
This morning I did 25 push - ups . My arms are exhausted . I feel sluggish !	push - ups	Push ups
Completed 25 push - ups this morning .   Arms are still sore .	push - ups	Push ups
I did 50 push - ups and my arms are tired now !	push - ups	Push ups
I just did over 100 pushups yesterday . I can barely lift a finger today .	pushups	Push ups
I just did thirty pushups . My arms are sore .	pushups	Push ups
I did 100 push ups and got tired	push ups	Push ups
Pushups I felt strong and pumped	Pushups	Push ups
SECOND WORKOUT IS PUSH UPS GOOD FEEL	PUSH UPS	Push ups
I did five sets of push - up I felt so drained and weak	push - up	Push ups
I just did 100 push ups My arms and chest are in pain	push ups	Push ups
I went to the gym and did lifting exercies for my chest I felt accomplished after my workout .	lifting	Push ups
I 've done fifty push - ups I felt really exhausted	push - ups	Push ups
I just did ten push ups . I feel sick .	push ups	Push ups
I done 50 push - ups , and felt so strong in my hands .	push - ups	Push ups
I did 20 pushups My arms felt weak	pushups	Push ups
10 push ups a day great	push ups	Push ups
I just did 100 pushups . My arms and aching and they are going to hurt really bad tomorrow .	pushups	Push ups
I have just done 20 push ups   My body feels ready for next excercise .	push ups	Push ups
I just did 50 pushups . That 's was a lot of work !	pushups	Push ups
I did 20 push - ups strong and pumped	push - ups	Push ups
  Pushups   very important exercise of body	Pushups	Push ups
I did 7 sets of Push - up i feel tired and drained	Push - up	Push ups
I did 5 pushups . my arms were tired ! !	pushups	Push ups
I did 10 pushups today . I felt very weak .	pushups	Push ups
i did 30 push ups i felt fulfilled	push ups	Push ups
I just did 30 push ups I m really sore now	push ups	Push ups
I did pushups I felt like my arms are falling off	pushups	Push ups
I did five sets of pushups today I felt exhausted from the effort !	pushups	Push ups
I just did 20 push ups . I felt like I was going to die	push up	Push ups
I did 30 push ups .   I felt my arms are trembling .	push ups	Push ups
I just did 200 jumping jacks . I felt very worn out afterwards .	jumping jacks	Push ups
i just did 10 push ups   when I was doing the 10 push ups i was having a hard time I felt tired	push ups	Push ups
I did 50 pushups . It was hard but I felt good after .	pushups	Push ups
I did twenty five pushups . My heart is racing and I 'm sweating a lot .	pushups	Push ups
I did fifteen pushups My abs hurt	pushups	Push ups
I did 8 push ups My arms hurt and I feel awful	push ups	Push ups
i worked out in gym and did 20 push ups and my muscles felt like they were going to torn out	push ups	Push ups
I did 50 pushups I felt really tired and sore	pushups	Push ups
push ups felt terrible	push ups	Push ups
I did about thirty push - ups and felt tired afterwards .	push - ups	Push ups
I did 10 pushups . I felt intense .	pushups	Push ups
I workout push - ups   I felt my arms are strong	  push - ups	Push ups
push ups take rest	push ups	Push ups
3 sets of 10 pushups I felt exhausted but felt good	pushups	Push ups
did 50 pushups up in a row , felt great	pushups	Push ups
I just did push ups for an hour My chest hurts .	push ups	Push ups
I just did fifty pushups . My muscles feel really sore .	pushups	Push ups
i did 15 pushups i felt worn out	pushups	Push ups
I did a set of 20 push ups and felt good after .	push ups	Push ups
I practice 10 minutes of push ups It makes me hard	push ups	Push ups
I did one hundred pushups . My arms hurt .	pushups	Push ups
I just walked 2 miles around the neighborhood .   I feel great .	walked	Walking
I just walked 3 laps around the building during my lunch hour I feel so refreshed	walked	Walking
I walked 600 steps around my house . I legs are feeling tired .	walked	Walking
I walked two miles .   My legs were tired , but overall I had more energy .	walked	Walking
Well , I reached my next goal today ; I finally hit the weight machines . I felt silly because I was n't sure how to operate the machine .	weight machines	Walking
I power walked 5 miles and felt so good that i wanted to go farther	walked	Walking
I just completed a 4 mile walk . I feel relaxed and refreshed .	walk	Walking
I walked for one hour . I felt dehydrated .	walked	Walking
I walked 3 miles in our subdivision , and although I felt better about myself , I was quite tired when I finished .	walked	Walking
I walked five miles with a friend today . I enjoyed the outdoors and the company , especially knowing I was getting some good exercise in to boot .	walked	Walking
I took a walk outside I felt energized after my walk	walk	Walking
I just walk a mile . I am very tired .	walk	Walking
I just did a warm up exercise . It felt very productive .	warm up	Walking
I walked on the treadmill for 8 miles today I felt exhausted because that was the longest I have walked in a while	walked	Walking
I spent an hour walking .   I was exhausted when I arrived home .	walking	Walking
I went for a 5 mile brisk walk I feel great !	walk	Walking
i walked 3 miles i felt accomplished and my legs were tired	walked	Walking
I just walked six miles . My legs felt like jelly .	walked	Walking
i went for a walk invigorated	walk	Walking
i walk two miles and i feel very restless .	walk	Walking
I walked for 2 miles It was boring !	walked	Walking
I walked for one mile . I felt invigorated !	walked	Walking
I walked for 30 minutes . I was bored but , felt refreshed .	walked	Walking
I walked for 15 minutes , and I feel awake .	walked	Walking
I just went for a one mile walk   I felt good	walk	Walking
i took a fast walk for an hour . I felt sweaty and out of breath after I got home .	fast walk	Walking
I walked on the treadmill .   I felt happy .	walked	Walking
I power walked for 40 mins . I felt really energized .	power walked	Walking
I walked thirty minutes . I felt better than when I started because I was doing something to help relieve stress	walked	Walking
I just walked four miles , and I feel exhausted .	walked	Walking
I went for a walk for an hour . My feet hurt a little , but I 'm fine otherwise .	walk	Walking
I regularly first workout is walking I fell very refresh of my body and mind .	walking	Walking
I walked 1 mile before work .   I felt tired , but it was a good tired .	walked	Walking
I walked briskly for 20 minutes I feel invigorated	walked	Walking
I walked on my treadmill for 20 minutes . I felt like my legs were wobbly .	walked	Walking
I just walked 5 miles . I felt relaxed .	walked	Walking
I walked two miles I felt rejuvenated	walked	Walking
I walked over two miles in my neighborhood . It felt amazing to get some fresh air .	walked	Walking
TODAY I WALKED FOR 100 MINUTES BRISKLY . I FELT ACCOMPLISHED AND SWEATY .	WALKED	Walking
I walked for 2 miles It was relaxing	walked	Walking
I did a brisk walk and felt really tired .	brisk walk	Walking
I walked a mile . I felt okay .	walked	Walking
I walked twice around the block . It 's surprisingly getting easier .	walked	Walking
walked for 30 mins around the neighborhood felt winded	walked	Walking
I just walked on the treadmill . It was boring .	walked	Walking
I just walked from here to the gym and back I am exhausted	walked	Walking
I walked one mile today . I was so tired after walking .	walked	Walking
i walked 3 miles today i felt sweaty and like i needed water	walked	Walking
I walk for an hour and I was tired and ready for a nap .	walk	Walking
I just walked 3 miles I felt bored .	walked	Walking
I walked for a mile today I felt good	walked	Walking
I walked two miles . I felt really out of shape .	walked	Walking
I took a brisk walk I felt energized	walk	Walking
I just walk 2 miles I feel energetic	walk	Walking
I just walked a mile uphill . My legs hurt really bad .	walked	Walking
I walked for 50 minutes . I feel good .	walked	Walking
i walked a mile on the treadmill i felt a little more engery	walked	Walking
I just walked 2 laps around the teack . I felt tired .	walked	Walking
I walked on the treadmill for 30 minutes . I felt relaxed , but happy for the movement .	walked	Walking
I walk non stop for one hour . Initially I would get tired and would have to talk to a friend or family member not to get distracted and to keep going .   I would get tired after the first 20 minutes .	walk	Walking
I did walk 20 minutes in a treadmill today . I felt so good after that 20 minute walk .	walk	Walking
I walked two miles It felt good .	walked	Walking
I walked for 15 blocks round trip I felt great first time I have done it .	walked	Walking
I just walked on the treadmill for one hour . My calves are so sore .	walked	Walking
i just walked briskly with bags of groceries i felt out of breath	walked	Walking
I walked four miles outside today I felt invigorated and energized	walked	Walking
I just power walked 5,000 steps . I feel invigorated !	power walked	Walking
I just walked my dog I felt at peace	walked	Walking
Walk thru town , excited	walk	Walking
I do Walking I am Very Tired	Walking	Walking
I walked 1 and a half miles . I felt great .	walked	Walking
I walked in place at a comfortable pace for seven minuites . As I was walking , I could feel that I was breathing slightly harder , but I was comfortable .	walked	Walking
I walked on the tredmill for about a hour . After the workout i felt refreshing	walked	Walking
I walked 4 miles I felt refreshed and energized	walked	Walking
I walked two miles today . I feel energetic .	walked	Walking
I walked a circle around downtown . I felt slightly tired and warm .	walked	Walking
I walked on the lakefront .   I felt relaxed .	walked	Walking
I walked 2 miles today . I felt great once I got past the first mile .	walked	Walking
I walked 2 miles on the treadmill . My legs were burning .	walked	Walking
i walked 1.5 miles i felt energized and ready to tackle the day	walked	Walking
I walked two miles today , it took me 30 minutes . I am tired , and my calves are hurting .	walked	Walking
I walked outside for 20 mintues . I felt energized and ready for the afternoon !	walked	Walking
I walked for 30 minutes I felt refreshed after the walking .	walked	Walking
Workout : I walked for 3hours . How I felt : I felt so good	walked	Walking
I walked for 10 miles and I felt tired	walked	Walking
i walked for 30 minutes on the treadmill today i felt really good as i read a book and the time flew by	walked	Walking
I went for a 6 mile walk . I feel energized !	walk	Walking
I waiked 9 holes I felt fine	waiked	Walking
I walked five miles on the trek   I felt invigorated	walked	Walking
I did ten minutes of cardio I felt winded	cardio	Walking
I walked five miles I felt energetic	walked	Walking
I went to the gym at lunch today and walked 2 miles in 30 minutes . I felt revived after I walked at lunch today .	walked	Walking
I walked for three miles and felt invigorated .	Walked	Walking
I walked 4 miles and I felt very tired .	walked	Walking
I went for a walk with my dog in the park . I was very relaxed .	walk	Walking
I took a 45-minute walk at the local nature preserve . The first 30 minutes were fine , but I was pretty tired towards the end .	walk	Walking
I walked 14 miles outside in the park . I enjoyed being outside , but by the end , I was exhausted	walked	Walking
I walked two miles outside around the park perimeter . I felt a little sad at first but cheered up as I went along .	walked	Walking
I just walked 5 miles   It was nice to get out of the house and active	walked	Walking
I walked for 5 miles and I feel great .	walked	Walking
I just did ten push ups . It was rough , but tolerable .	push ups	Walking
The second workout was also walking , I got tired again but was thinking of the ultimate goal . After the second workout I was sweating and a little tired .   But   felt good that I accomplished my goal .	walking	Walking
My first mile speed walk I worried I woulnt make it but did .   I felt terrific .	walk	Walking
I walked 2 miles . I felt winded but overall accomplished .	walked	Walking
I walked one mile today at the track . My legs are hurting and my calves are tight .	walked	Walking
I walked 4 miles I felt invigorated	walked	Walking
I walked for an hour I am tired	walked	Walking
I walked a mile this morning .   I felt sore when I was done .	walked	Walking
I walked for a total of two miles . I enjoyed the walk but was kinda tired at the end .	walked	Walking
I took a five - mile walk . I felt re - energized .	walk	Walking
I walked down the street for 15 minutes . I need to do this more often so I 'm not so winded next time .	walked	Walking
Secondly I walk around the block three times . It gets my blood flowing and warms up my muscles for the day .	walk	Walking
Walk at home exercise Felt strength	Walk	Walking
I walked 5 miles I felt calm and confident	walked	Walking
I just finished walking 3.1 miles .    I feel tired but very pleased .	walking	Walking
I just walked 4 blocks   I felt exhausted	walked	Walking
walked to my local gym which is one mile away from my apartment I felt good but very tired and sweaty	walked	Walking
I walked around the house for 20 minutes . I enjoyed walking and listening to music .	walked	Walking
I walked for 2 miles It was good	walked	Walking
I power - walked 4.2 miles . I felt stiff and achy afterwards .	power - walked	Walking
I just walked uphill a couple of miles . I was out of breath .	walked	Walking
walking get start	walking	Walking
I walked one lap and it rained , I was miserable .	Walked	Walking
I walked for one hour I feel tired	walked	Walking
  MY FIRST WORKOUT IS WALKING I FELT BETTER	WALKING	Walking
I walked for ten minutes . I felt warmed up .	walked	Walking
I walked 5 miles I feel very accomplished	walked	Walking
I walked 5 miles and boy my legs are tired	walked	Walking
I took a brisk walk around the park warmed up , a little hot , loose .	brisk walk	Walking
I walked 30 minutes on the treadmill . I felt tired after the workout .	walked	Walking
I walked two miles . I felt energized !	walked	Walking
I took a 3 mile walk . I feel so energized !	walk	Walking
I went walking   I felt refreshed	walking	Walking
I walking 30 minutes a day . i felt great .	walking	Walking
I walked on the treadmill for twenty minutes . My legs were very tired .	walked	Walking
I was walking briskly around Central Park I felt very relieved after this work out	walking	Walking
I walked the dog for a mile and felt refreshed .	walked	Walking
My second workout walking was better than my first . I felt , after my second workout , that I was making some progress in forming a habit .	walking	Walking
I walked at a very brisk pace through the mall - from one end to the other which is reportedly a mile - twice .   I felt invigorated and really enjoyed it .   By the time I finished , I was tired and ready to go .	walked	Walking
I was able to walk 2.5 miles this afternoon . My legs and feet were pretty sore !	walk	Walking
I just walked 4 miles going to Joe 's and back . At first I was n't sure how I would do , but I felt and feel great !	walked	Walking
I walked for 6000 steps . It felt great .	walked	Walking
I went for a walk Very relaxing	walk	Walking
I walked 3.0 miles . I felt energized .	walked	Walking
I walked 5 miles this morning My hips are sore .	walked	Walking
I went for a rigorous walk around the neighborhood . I felt refreshed and tired at the same time .	walk	Walking
I walked 60 minutes I feel energized	walked	Walking
I walked two miles . It felt good .	walked	Walking
I walked 2 miles I felt like i accomplished something .	walked	Walking
I walked two miles I am tired and sore .	walked	Walking
I took a long walk on the beach . I felt refreshed .	walk	Walking
I just walked 3 miles I am very relaxed	walked	Walking
  I walk in morning      I feel refresh	walk	Walking
I walked 2 miles last week I felt super tired	walk	Walking
I just walked 7 blocks ! I feel energized !	walked	Walking
I walked 3 miles and now feel more energized	walked	Walking
Walked 1.6 miles down McDaniels to Kings Circle and back . Felt good , good pace .	Walked	Walking
I walked outside for 30 minutes . I felt energized .	walked	Walking
I just speed walked five miles . I felt exhausted but energized .	walked	Walking
I just walked 2 miles I feel energized	walked	Walking
I did three hours walking on the treadmill . I felt exhausted !	walking	Walking
I walked for an hour on the treadmill . I felt extremely bored and wished it would end .	walked	Walking
I took a walk . I felt refreshed .	walk	Walking
I walked on treadmill 30 minutes I feel very satisfied	walked	Walking
I walked the dog I felt refreshed	walked	Walking
I walked two miles outside . I feel refreshed .	walked	Walking
I walked 15,000 steps today . It makes my legs feel sore .	walked	Walking
I started doing speed walking . Exhausted and sore	speed walking	Walking
Just took a long walk in the neighborhood I am finally able to get out and exercise again .   I feel invigorated !	walk	Walking
I walked on the treadmill for 60 minutes . My legs are weak and I want to sit .	walked	Walking
I walked two miles . My legs were burning .	walked	Walking
I walked down to the river and my achilles hurt .	walked	Walking
I walked up and down a flight of stairs 3 times .    During the 3rd time up the muscles in my legs felt like they were on fire .	walked	Walking
I walked 1 hour I feel good	walked	Walking
I walked 3 miles . I felt great .	walked	Walking
I walked at the park & pushed my kids in a stroller .   I felt powerful as I pushed a double stroller in a hilly park . I felt tired after we were done though .	walked	Walking
I walked 4 miles I felt good !	walked	Walking
I walked 4 miles . My walk was energizing !	walked	Walking
I walked a half mile around the neighborhood earlier . I feel invigorated and alive .	walk	Walking
I went for a walk today . I felt tired .	walk	Walking
I walked 2 miles and I felt tired .	walked	Walking
I spent an hour on the treadmill . I felt motivated .	treadmill	Walking
I just walked two blocks to the store . I felt great and invigorated .	walked	Walking
  I did my 10000 steps for the day Feel good l completed my target of 10000 steps	steps	Walking
I just walked five miles around my neighborhood . I felt good and healthy .	walked	Walking
I walked on the treadmill for 45 minutes . I was more tired than usual but finished my workout .	walked	Walking
I walked the 20 minutes to work at a quick pace while wearing my loaded backpack .   I felt a little tired and a little bit sweaty but ready to use my brains .	walked	Walking
I walked on a treadmil at the gym for an hour and I felt accomplished after .	walked	Walking
WALKING IS MY FIRST WORKOUT .   I FEEL BETTER AFTER PERFORMING THE FIRST WORKOUT .	WALKING	Walking
I took a 20 minute walk around the neighborhood . I felt tired , but refreshed afterward .	walk	Walking
I also walked the track It sucked if i 'm being honest .	walked	Walking
I walked briskly through the mall three times this morning without stopping I felt invigorated	walked	Walking
I just walked for six miles . I feel good and it was a nice day out .	walked	Walking
Walked for an hour I felt good , but also sweaty	Walked	Walking
I walked 2 km I felt good about myself .	walked	Walking
i walked for 1 mile and it felt good	walked	Walking
I WALKED TEN KILOMETERS I FEEL GOOD AND ENERGETIC	WALKED	Walking
I walked a mile . I am out of shape !	walked	Walking
I just fast walked 3 miles I felt empowered	fast walked	Walking
I just walked my dog for 1 mile It felt great	walked	Walking
I Went for Walking very tired	Walking	Walking
Just walked three miles . My shins are sore and I feel so out of shape .	walked	Walking
I walked 60 minutes today . I felt energized after my walk .	walked	Walking
I power walked for 30 minutes I felt refreshed and rejuvenated	walked	Walking
I just walked 1.60 miles on the old Falcon Nest golf course Felt good , a little out of breath , but good .	walked	Walking
I walk thirty minutes a night . I felt more happier after workout .	walk	Walking
I took my dog for a walk and I felt refreshed .	walk	Walking
I walked the track for a hour . I felt great .	walked	Walking
I walked 5 miles .   I felt rejuvenated .	walked	Walking
I just completed 60 minutes on the treadmill . I feel great !	treadmill	Walking
I did 5 miles on the treadmill . It was at an incline so my legs are hurting .	treadmill	Walking
I walked on the treadmill for 30 minutes . After it was over I felt exhausted .	walked	Walking
I walked 2 miles It was difficult but afterwards I felt energized	walked	Walking
walking in the park I felt excellent	walking	Walking
Walked around one city block I felt energized and stimulated	walked	Walking
I walked three miles .   I was extremely tired afterwards .	walked	Walking
I just walked 2 and a half miles ! I feel so refreshed !	walked	Walking
I walked 4 miles on the treadmill . I felt energized .	walked	Walking
I walked on the treadmill for an hour .   I felt tired afterward .	walked	Walking
I walked one mile . My legs are too weak !	walked	Walking
I walked a mile , and I felt good .	walked	Walking
I walked my go for 90 minutes My feet were a little achy but I felt great otherwise	walked	Walking
Leslie sansone walking exercise I felt So light and fresh	walking	Walking
incline walking for 15 minutes i can not feel my legs , great workout !	incline walking	Walking
I just finished one hour on the treadmill I felt really good and ready for more	treadmill	Walking
I walked for two hours and felt very tired afterwards	walked	Walking
I just walk 30 minutes I felt great .	walk	Walking
I walked today I was tired going in but after I felt more awake	walked	Walking
I just walked three miles I should do this everyday because I feel better .	walked	Walking
I walked around White Rock lake with my husband . I felt energized .	walked	Walking
I walked 1 mile . My legs hurt .	walked	Walking
brisk walking energized	walking	Walking
I just walked 40 minutes on the treadmill at an incline of 3 % . I felt out of breath and tired .	walked	Walking
I went on a 5 mile walk . It felt good to go on that walk .	walk	Walking
I walk early morning Reduce fat	walk	Walking
I walked four miles on the treadmill . I felt invigorated .	walked	Walking
I just walked for 35 minutes . I felt fresh .	walked	Walking
I just walked 3 miles and I felt so tired .	walked	Walking
I just walked half a mile . I feel energized .	walked	Walking
Speed walking a mile in under 20 min . I was so exhausted , hot and sore .	Speed walking	Walking
I walked for 20 minutes I felt great	walked	Walking
I walked around the track . I was out of breath	walked	Walking
I WALK FIVE MILES AND I FELT VERY TIRED .	WALK	Walking
I walked for 1 mile . I am more out of shape than I realized .	walked	Walking
I walked for 30 minutes . I felt energized .	walked	Walking
I walked for 45 mins . I felt tired but also energized .	walked	Walking
I walked 2 miles and felt energized	walked	Walking
I feel great ! I just walked five miles .	walked	Walking
I walked two and a half miles . I fell more freshened .	walked	Walking
I walked 2 miles on the treadmill . I felt great walking .	walked	Walking
My second workout today was walking with the treadmill . I felt relaxed .	walking	Walking
i walked around 10 miles and felt like exhausted	walked	Walking
I walked 1.3 miles at a very brisk pace , and felt loosened up and less sore .	walked	Walking
I WALKED FOR THREE MILES . I FELT FRESH .	WALKED	Walking
I walked two miles . I am wore out !	walked	Walking
I walked around the park for 30 minutes . I felt awake and warmed up .	walked	Walking
I walked for 3 miles . That was very enjoyable .	walked	Walking
I did the treadmill for 45 minutes It was boring	treadmill	Walking
I speed - walked one mile . I felt invigorated .	speed - walked	Walking
My second workout I walked 4 miles After my workout I felt energized	walked	Walking
I walked 2 miles . I felt relaxed .	walked	Walking
I walked for 30 minutes .   I feel really refreshed .	walked	Walking
I walked vigorously for 20 minutes . I feel energized !	walked	Walking
I just walked a fast 3 miles and I feel exhausted and sore already	walked	Walking
My dogs love to go for walks , so taking them outside for a 2 mile walk is good for mental health reasons and physically . I felt joyful and inspired while walking with my dogs outside , being with nature , saying hello to people , it was amazing .	walks	Walking
I walked for 30 minutes . It was invigorating .	walked	Walking
I walked 2 miles . I felt slightly out of breath afterwards .	walked	Walking
I walked around the block two times I felt refreshed and more lively	walked	Walking
I walked 2 miles and felt more alert and upbeat .	walked	Walking
I walked three miles on the treadmill . I was bored .	walked	Walking
walk around the block every other day very good	walk	Walking
I just walked in place for an hour . It was easy and pleasant .	walked	Walking
walked on treadmill i 'm tired and need to walk more	walked	Walking
I walked on the treadmill on an incline for 45 minutes . I am drenched in sweat now .	treadmill	Walking
I just went on a forty minute walk . It was hot and I got very sweaty .	walk	Walking
I walked for 30 minutes I felt good being outside	walked	Walking
I went on a walk at lunch today . It was nice to get fresh air and be active .	walk	Walking
I tried treadmill and it was amazing . I felt excited before and after .	treadmill	Walking
I walked 10 blocks it was fine	walked	Walking
I walked 5 miles around the park The fresh air was invigorating	walk	Walking
I just finish my 1 hour treadmill workout . Yehh , i feel much more lighter now .	treadmill workout	Walking
I worked out on my treadmill downstairs for 30 minutes , while watching Young and The Restless .    While working out I felt tired but afterwards I felt I did a great job , and I felt much better moodwise .	treadmill	Walking
i walked 3 miles after work i broke a sweat and felt good	walked	Walking
I did brisk walking for 30 minutes . I feel tired .	walking	Walking
I walked for 5 miles . I feel really tired and my legs are sore .	walked	Walking
I walked along the river on the walking path . I felt great , like I was making very good time .	walked	Walking
I just walked around the block twice . ( 1 mile ) I felt like I could n't breathe .	walked	Walking
I went for an hour - long walk with my dog . I felt energized and happy .	walk	Walking
I walked two miles . I felt energized .	walked	Walking
I walked a mile . My hips are sore .	walked	Walking
I decided to start walking for exercise . It felt refreshing , but the hills were difficult .	walking	Walking
I walked 2 miles . I was winded during the walk , but felt great after .	walked	Walking
I just did 45 minutes on the elliptical . I feel great and energized .	elliptical	Elliptical Machine
I ran on the elliptical for half an hour . I felt invigorated .	ran	Elliptical Machine
I just went on an elliptical for an hour . It was exhausting .	elliptical	Elliptical Machine
I just did 30 minutes on the elliptical . I feel so tired and sore .	elliptical	Elliptical Machine
I used an elliptical for 1 hour It was easy	elliptical	Elliptical Machine
I just did 1 hour of Random Hills on the elliptical machine My legs felt like bricks !	elliptical machine	Elliptical Machine
I did the elliptical for 40 minutes I felt sweaty	elliptical	Elliptical Machine
I did the elliptical for 40 minutes I felt sweaty , hot and good	elliptical	Elliptical Machine
I was on the elliptical for 45 minutes My legs hurt , so i 'm feeling a little worn	elliptical	Elliptical Machine
i did 20 minutes on my elliptical my legs felt like spaghetti noodles after	elliptical	Elliptical Machine
I did 30 minutes on the elliptical machine . I feel energized .	elliptical machine	Elliptical Machine
I worked out on the elliptical for 30 minutes I feel tired and my legs are sore .	elliptical	Elliptical Machine
I used the elliptical machine for an hour . I feel tired from moving my arms and legs .	elliptical machine	Elliptical Machine
I worked out inside on the elliptical machine for 30 minutes I was winded , but got through . My legs were a little shaky and my feet were starting to get numb .	elliptical	Elliptical Machine
I workout on the elliptical indoors for 45 minutes . Felt like I did okay , but it was very boring .	elliptical	Elliptical Machine
I did six miles on the elliptical . I felt exhilerated .	elliptical	Elliptical Machine
I did thirty minutes on the elliptical machine I feel sweaty but energized	elliptical machine	Elliptical Machine
I spent one hour on the elliptical machine . I felt outstanding and exhilarating .	elliptical machine	Elliptical Machine
  I worked out on the elliptical . It was invigorating .	elliptical	Elliptical Machine
I just ran 30 minutes on the elliptical .   I feel sweaty .	elliptical	Elliptical Machine
I did 15 minutes on the elliptical and feel pained .	elliptical	Elliptical Machine
I worked out on the elliptical for a half hour .   It felt nice since the elliptical is not a straining workout .	elliptical	Elliptical Machine
I did elliptical cardio at the gym for 30 minutes I felt a lot refreshed and more energetic	elliptical cardio	Elliptical Machine
I did the elliptical for an hour today   better then i did on the treadmill	elliptical	Elliptical Machine
I spent 45 minutes on the elliptical machine . It felt good for my muscles but felt like longer than 45 minutes .	elliptical machine	Elliptical Machine
I just used the elliptical trainer . I really pushed myself .	elliptical	Elliptical Machine
""""""" I just spent twenty minutes on the elliptical . """" """" I feel energized ! """""""	elliptical	Elliptical Machine
I felt energized and refreshed after using the elliptical for 25 minutes .	elliptical	Elliptical Machine
I just did 30 minutes on the eliptical . I felt invigorated	eliptical	Elliptical Machine
I spent 30 minutes on the elliptical and was winded and exhausted .	elliptical	Elliptical Machine
I did a workout on the stepper at home . I started out strong , but got pretty tired by the end of the workout .	stepper	Elliptical Machine
My legs felt like jelly after using the elliptical for 45 minutes today .	elliptical	Elliptical Machine
I did 40 minutes on the cross trainer . My legs feel like jello and I 'm unstable on the solid ground .	cross trainer	Elliptical Machine
elliptical I felt bloated and tired	elliptical	Elliptical Machine
I just did 25 minutes straight on the elliptical machine . I felt like a boss while my legs pumped back and forth .	elliptical machine	Elliptical Machine
I just ran on the elliptical for one hour . I feel super tired .	elliptical	Elliptical Machine
I used the elliptical for 1 hour It was strenuous	elliptical	Elliptical Machine
I just did 2 miles on the elliptical machine in 10 minutes . I feel so much better about myself now .	elliptical	Elliptical Machine
I used the elipitical . I was bored .	elipitical	Elliptical Machine
Elliptical I felt my hands and legs were both stiff and soar .	Elliptical	Elliptical Machine
I just did a 20 minute spin class I ca n't feel my legs	spin class	Elliptical Machine
I did 4 miles on the elliptical . After it , my legs felt weak and tired .	elliptical	Elliptical Machine
I walked 3 miles on the elliptical My legs are sore	elliptical	Elliptical Machine
I worked out on the elliptical machine for 20 minutes .   I felt like I was being stretched on the rack !	elliptical machine	Elliptical Machine
I just did the elliptical for 28 mins I feel energized , it's great to sweat	elliptical	Elliptical Machine
I did 15 minutes on the elliptical . My legs are so sore	elliptical	Elliptical Machine
I spent 30 minutes on the elliptical .   I felt very accomplished .	elliptical	Elliptical Machine
i just did 15 minutes on elliptical i felt energized	elliptical	Elliptical Machine
I like to use the elliptical machine I feel like   it builds arm and leg muscles	elliptical machine	Elliptical Machine
30 minutes on the eliptical I was really bored	eliptical	Elliptical Machine
I worked out on the elliptical for 50 minutes . It was hard work but very energizing .	elliptical	Elliptical Machine
Strength exercises It make my muscles stronger .	Strength	Elliptical Machine
I spent 20 minutes on the elliptical . I was tired by the end .	elliptical	Elliptical Machine
I just did 1 hour in the elliptic I am exhausted !	elliptic	Elliptical Machine
I ran on an ellpitcal for 35 minutes . I feel exhausted .	ran	Elliptical Machine
i did the eliptical for 20 mins i felt better and tired	eliptical	Elliptical Machine
I worked out on the elliptical for 30 minutes . I felt completely exhausted !	elliptical	Elliptical Machine
I worked out for 20 minutes on the elliptical   My legs feel like jelly	elliptical	Elliptical Machine
I weight lifted at the gym today I feel refreshed	weight lifted	Weights, general
I lifted a lot of weights and felt so sore the next 2 days .	lifted	Weights, general
i lifted weights at the gym and felt pumped after	lifted	Weights, general
Lifting weights . I am not very strong so I can not lift very heavy and I always feel a little sore afterwards but I felt determined and interested in what I was doing . And I felt proud that I was doing it and going through any discomfort or hurdles .	Lifting weights	Weights, general
I just lifted for 75 minutes ! I felt strong .	lifted	Weights, general
I did weightlifting It was good	weightlifting	Weights, general
I lifted weights for 30 minutes . I felt tired .	lifted weights	Weights, general
Three times a week , I go to the gym and lift weights .   I feel sore for about a day after I work out , then I feel stronger .	weights	Weights, general
I lifted back for two hours . I felt like the weight was heavy today .	lifted	Weights, general
I just lifted chest and tris today . I felt very strong doing so because I hit my new max	lifted	Weights, general
I worked out on the weights for a half hour . I felt very satisfied after ,	weights	Weights, general
I lifted weights for 45 minutes and I feel sore .	lifted	Weights, general
I lifted weights . My arms are sore .	lifted	Weights, general
I lifted weights for 30 minutes and felt rejuvenated	weights	Weights, general
I just lifted some weights I felt so strong afterwards .	lifted	Weights, general
I went to the gym for the first time and did weight training exercises . I felt out of breath and sore but determined .	weight training	Weights, general
I ca n't believe I started lifting weights again . My arms feel like complete rubber this morning .	lifting weights	Weights, general
I lifted weights and worked my chest , shoulders and triceps . I felt weak during my heavier bench presses .	lifted weights	Weights, general
I arm wrestled at the club today . My shoulder is really aching now .	arm wrestled	Weights, general
i weight lifted for 1 hour and felt sore but also clear headed and energized	weight lifted	Weights, general
I went upstairs to go and focus on weights .   I felt pumped up	weights	Weights, general
i used the leg press i felt very strong ; i was able to increase my weight load up to 130 lbs and keep proper form while doing it slow and controlled	leg press	Weights, general
i used 35 lb dumbbells my biceps and shoulders were throbbing	dumbbells	Weights, general
I took a weight lifting class . I felt good , had lots of energy .	weight lifting	Weights, general
I lifted weights . I felt so weak .	lifted weights	Weights, general
I worked my back muscles for 20 minutes today .   I feel sore .	worked my back muscles	Weights, general
I lifted weights for about 45 minutes after work . I 'm know that I 'm going to be sore in the morning due to the holiday break .	weights	Weights, general
I lifted weights and can feel the adrenaline flowing !	weights	Weights, general
I lifted weights for 45 minutes .   I was very sore afterwards .	lifted	Weights, general
I did shoulder press with dumb bells . I felt sore afterwards but pleased .	shoulder press	Weights, general
I just lifted weights at the gym I felt really empowered after doing this work out	lifted	Weights, general
I lifted weights I felt very strong and powerful	lifted	Weights, general
I did squats and my legs were on fire !	squats	Weights, general
i take weight lifting in Gym . Then i feel fitness .	weight lifting	Weights, general
I just did 50 snatches with a 20 lb . kettlebell . I feel alive !	snatches	Weights, general
I lifted weights using dumbbells and felt exhausted after .	lifted weights	Weights, general
i lifted weights for 45 minutes i felt exhausted , i 'm out of shape	lifted weights	Weights, general
I did 10 sets of 12 reps on the weight machines . My muscles hurt .	weight machines	Weights, general
I did weight lifting for 20 minutes . My arms are sore .	weight	Weights, general
I did a dumb bell exercise for 30 minutes   I felt okay and wanted to do it again !	dumb bell exercise	Weights, general
I lifted weights today . I felt really strong .	lifted	Weights, general
I did some weight lifting cable machines . I felt good it made me work up a sweat .	weight lifting	Weights, general
I did isolated bar bell lifts on m biceps .   My arm feels good .	lifts	Weights, general
I went to my barbell class and felt so energized afterwards	barbell class	Weights, general
I lifted weights for 30 mins . I feel strong !	lifted	Weights, general
I did a heavy weight exercise today and it made my muscles very sore .	weight	Weights, general
I did 40 hip thrusts . I feel powerful .	hip thrusts	Weights, general
i take a weight lifting and general exercise . then i feel fit .	weight lifting	Weights, general
i lifted free weights felt like i could add more weights	lifted	Weights, general
I lifted weights for an hour and I felt great .	lifted weights	Weights, general
I lifted weights I felt tired but happy .	lifted	Weights, general
I lifted weights I felt weak	lifted	Weights, general
My second work out would start with my hand weights . I would lift the weights up and work my arms with the hand weights . I have a couple variations of how I lift them . I start trying to wear my self out with the hand weight workout , so I am getting tired .	lift hand weights	Weights, general
I lifted weights for 15 minutes . I felt sore .	lifted weights	Weights, general
I did 4 sets of incline barbell press . I felt great . The weight seemed lighter than usual .	incline barbell press	Weights, general
I would lift 20 pound weights I would feel sore .	weights	Weights, general
lift weights i felt strong	lift weights	Weights, general
I lifted legs today ! I was tired from being sick	lifted legs	Weights, general
I lifted weights for 1 hour . I felt empowered .	lifted	Weights, general
I lifted weights My muscles are sore	weights	Weights, general
I lifted weights for about 10 minutes   My arms were burning during and afterward .	lifted	Weights, general
I lifted weights and worked my legs , back and biceps . I felt weak doing squats since I have n't done them in a while .	lifted weights	Weights, general
I spent thirty minutes lifting free weights . I am tired , but my muscles are pleasantly tingling .	lifting	Weights, general
I lifted weights and used the bench press . worn out but satisfied .	lifted weights	Weights, general
I lifted weighs for an hour I felt really spent and needed to relax	lifted	Weights, general
my second workout was a free - weight and body weight workout which was also monitored via a smart watch this workout was also enjoyable since i like working out but a lot more demanding and tougher compared to the previous workout	free - weight	Weights, general
I lifted 70 pounds of weights . I felt a bit tired after doing the weight lifting .	lifted	Weights, general
I lifted some weights focusing on legs and felt amazing and energized after .	lifted	Weights, general
I just lifted a kettlebell 25 times . I felt exhausted .	kettlebell	Weights, general
I did 3 sets of 15 hand grip pulls on each hand . I felt like I completed a first step .	hand grip pulls	Weights, general
i worked out on the weight machine I felt hot , tired and sweaty after I finished	weight machine	Weights, general
i take a weight lifting in Gym . i feel body fitness	weight lifting	Weights, general
I lifted weights I felt tired	lifted	Weights, general
I lifted weights . I felt powerful .	lifted	Weights, general
I lifted weights for 30 minutes . I felt sore but at the same time felt great .	lifted weights	Weights, general
I lifted weights for 30 minutes . It made me sore .	lifted	Weights, general
I did three sets of 8 on bench press . I increased weight and felt accomplished .	bench press	Weights, general
i pulled some weights   i felt very tired	weights	Weights, general
I lifted weights I felt sore	lifted	Weights, general
I did the weight training again and repeated the same exercises as my previous workout . I felt a bit more strong and confident .	weight training	Weights, general
I did upper body workout for 30min and felt strong .	upper body workout	Weights, general
I lifted weights at the gym . I felt exhausted .	lifted	Weights, general
I just did shoulder presses . I felt amazing !	presses	Weights, general
I did a leg workout with weights . I felt weak but determined during this workout .	weights	Weights, general
I just lifted weights I feel stronger	weights	Weights, general
I lifted for an hour I felt like an athlete	lifted	Weights, general
I lifted heavy weights for 30 minutes .   My muscles are sore .	weights	Weights, general
I did weight training for 30 minutes . I felt invigorated .	weight	Weights, general
I went to the gym and did a super slow workout on the weight machines . I had a sore leg muscle after working out on the weight machines .	weight machines	Weights, general
I did a 30 upper body weightlifting routine I felt like I am making good progeres	upper body weightlifting	Weights, general
i did culs for 15 minutes my arms were burning	culs	Weights, general
I spent 45 minutes lifting weights this morning . I 'm tired am keeping my promise to lift weights once per week .	lifting weights	Weights, general
I used my weight machine to do presses I felt physically tired , but great	presses	Weights, general
I just finished lifting weights for 2 hours .   I felt great after the 2 hour workout and I feel really strong .	lifting weights	Weights, general
I did 50 barbell rows I feel accomplished	barbell rows	Weights, general
I worked out with free weights for 30 minutes and I felt great afterwards !	free weights	Weights, general
I did weight lifting at the gym for one hour . I felt energized .	weight lifting	Weights, general
I just lifted 5 pound weights for thirty minutes I felt tired	weights	Weights, general
I did some weightlifting for thirty minutes . My upper body was very tired .	weightlifting	Weights, general
I lifted weights and felt strong !	weights	Weights, general
I lifted weights I felt tested	weights	Weights, general
I just finished lifting weights upper body workout It felt good	lifting	Weights, general
I did some free weight exercises today It made my arms get sore .	free weight exercises	Weights, general
I just finished 30 minutes of weight lifting I feel like I need to workout more	weight lifting	Weights, general
I lifted weights and felt exhausted	lifted	Weights, general
I lifted weights for one hour . I felt weak .	lifted	Weights, general
I just did thirty crunches . My abs are shaky !	crunches	Abdominal Crunches
i did 20 sit up after i was done i could feel it in my stomach .	sit up	Abdominal Crunches
I just did fifty situps and fifty vee - ups . My abs are burning , and I 'm out of breath .	situps	Abdominal Crunches
I did 1 minute of push ups stomach burns	push ups	Abdominal Crunches
Today I did 2 sets of 20 crunches . My legs are killing me !	crunches	Abdominal Crunches
I did an abs workout of 3 set of 15 reps It was hard but I felt good after	abs workout	Abdominal Crunches
i just did 80 ab crunches set at 50lbs . i felt a little tight in the chest	ab crunches	Abdominal Crunches
I did 15 russian twists , which makes me feel invigorated	russian twists	Abdominal Crunches
I just finished 100 crunches My abs are pretty sore , I feel like I might throw up	crunches	Abdominal Crunches
I performed stomach crunches . I felt toned .	stomach crunches	Abdominal Crunches
I did two sets of twenty crunches ! My abs are on fire !	crunches	Abdominal Crunches
I did 100 crunches in 5 minuets . I felt like my abs were on fire .	crunches	Abdominal Crunches
I did 30 sit ups I thought i was nt able to finish them	sit ups	Abdominal Crunches
I did a 30 crunches and felt warmed up .	crunches	Abdominal Crunches
I did two hundred ab crunches over five sets . The last 50 reps were terrible , I felt so tired .	ab crunches	Abdominal Crunches
I did ten sit ups I feel tired but still motivated to do more	sit ups	Abdominal Crunches
I did thirty sit - ups today ! My back is killing me !	sit - ups	Abdominal Crunches
i did 100 crunches my abs hurt	crunches	Abdominal Crunches
I just finished 30 crunches . My ab muscles are sore .	crunches	Abdominal Crunches
I did crunches   I felt very strong and powerful	crunches	Abdominal Crunches
I did a 20 minute ab workout .   I felt horrible .	ab workout	Abdominal Crunches
Workout : 60 crunches in sets of 15 . I felt good , like I was getting stronger .	crunches	Abdominal Crunches
I did 3 sets of crunches . my abs were destroyed .	crunches	Abdominal Crunches
I just did 50 crunches . I can feel the burn in my abs .	crunches	Abdominal Crunches
I did 25 stomach crunches I felt sweaty	stomach crunches	Abdominal Crunches
I did ab work It was gasy	ab	Abdominal Crunches
I did crunches on an exercise ball I felt energized	crunches	Abdominal Crunches
I did 100 crunches . I am so out of shape , my abs are aching so bad .	crunches	Abdominal Crunches
I did an ab workout and I felt sore afterwards .	Ab workout	Abdominal Crunches
i just did 50 situps i feel in pain	situps	Abdominal Crunches
I just did twenty crunches i feel better	crunches	Abdominal Crunches
I did 25 situps . I felt tired and in pain .	situps	Abdominal Crunches
I did 3 sets of 30 crunches i felt tired and worn down .	crunches	Abdominal Crunches
I did 300 crunches My abs felt like they were on fire	crunches	Abdominal Crunches
I did 100 sit - ups . My stomach hurts and it was hard .	sit - ups	Abdominal Crunches
I did ab crunches . I felt comfortable and happy to do this movement .	ab crunches	Abdominal Crunches
I did 100 crunches . I could n't get out of bed the next morning .	crunches	Abdominal Crunches
I did an abs rotation my tummy is on fire .	abs rotation	Abdominal Crunches
I did an online ab workout . My stomach feels queasy .	ab workout	Abdominal Crunches
I just did 5 sets of 25 sit - ups . Gosh my stomach is feeling it .	sit - ups	Abdominal Crunches
I did a 45 minute HIIT workout . I feel energized and great .	HIIT	Interval Training
I completed a hiit class I am tired and sweaty	hiit class	Interval Training
I did an insanity workout video . Initially , I felt sore after completing the work out but after cooling down I felt good about myself and what my body was capable of doing .	insanity workout	Interval Training
I did 30 minutes of high intensity training . I felt full of energy .	high intensity training	Interval Training
I did HIIT training for 1 hour I felt sick	HIIT	Interval Training
I just did 10 suicides That was the hardest ever	suicides	Interval Training
I just ran intervals for 30 minutes . I felt great .	intervals	Interval Training
I did thirty minutes of a high intensity training workout and I felt hungry .	high intensity training	Interval Training
I did a 30 min HIIT style workout It was hard but I felt good after	HIIT	Interval Training
I did a HIIT training workout for 45 minutes . I felt out of breath and tired .	HIIT training	Interval Training
20 minutes of intense cardio   felt like dying , out of breathe !	intense cardio	Interval Training
I did a 30 minute bodyweight plyometric circuit . I enjoyed the feeling of getting stronger .	bodyweight plyometric circuit	Interval Training
I did thirty minutes of high intensity training and felt full of vitality .	high intensity training	Interval Training
I went to crosfit this afternoon and did a variety of exercise .	crosfit	Interval Training
I did a high intensity interval training video I felt very sore .	high intensity interval training	Interval Training
I did a 30 minute HIIT workout today . I felt tired and a little out of shape .	HIIT workout	Interval Training
I did some circuit training focusing on my arms and back . I feel a tremendous burn in my arms and shoulders and think I may have overdid it .	circuit training	Interval Training
I    did interval workouts I 'm exhausted and sore	interval workouts	Interval Training
I did 3 sets of Bench presses My chest felt activated and sore after	Bench presses	Bench press
I went to gym and did an hour of weight lifting . I felt good during , but now I am feeling a little sore .	lifting	Bench press
I did 10 chest press .   Afterwards I felt weak and shaky	chest press	Bench press
I did 15 military presses I feel sore	military presses	Bench press
I did a tough bench press workout I felt exhausted after the workout	bench press	Bench press
I completed an hour chest workout and I feel energized .	chest workout	Bench press
I bench pressed 100lbs 10 times . My muscles started to sting !	bench pressed	Bench press
I just did chest volume workout 1 Fatigued from the finisher need nutrition fast	chest volume	Bench press
I did 3 sets of bench press . My arms were getting tired .	bench press	Bench press
I benchpressed some weights . I felt strong and impressed that I did it .	benchpressed	Bench press
It was quite difficult doing the bench press . I was really exhausted .	bench press	Bench press
I did chest presses on the squat rack I 'm a little sore	chest presses	Bench press
My second work out was lifting weights My pecs felt they were on fire	lifting weights	Bench press
3 sets of 10 reps Bench Press felt energized after completing	Bench Press	Bench press
I did the bench press . I felt tight .	bench press	Bench press
I did a set of dumbbell bench press My chest was very sore afterwards .	dumbbell bench press	Bench press
After that first workout I tried to go for a bench press with my other friend   I felt really great and that was the day when I decided to work out regularly	bench press	Bench press
I just bench pressed for five sets . It was tiring .	bench pressed	Bench press
Did bench press today , feeling pumped !	bench press	Bench press
I bench pressed 40 pounds . My arms feel like jello .	bench pressed	Bench press
I bench pressed 120 pounds . I was struggling during the workout to lift the weight .	bench pressed	Bench press
I did nine sets of bench press today , hitting 225 pounds for 5 reps on my heaviest set . I feel real strong and excited with my progress .	bench press	Bench press
I lifted weights for 45 minutes . I felt like I had a lot of strength	lifted	Bench press
I lifted weights at the gym today . My arms are so sore today .	lifted	Bench press
I did 4 sets of bench - press . My arms hurt and I 'm out of breath .	bench - press	Bench press
i lifted weights for an hour i felt pumped up .	lifted	Bench press
I did heavy bench presses . I felt stronger than I thought I would !	bench presses	Bench press
i bench pressed for 5 sets of 5 seps my arm were tired	bench pressed	Bench press
I did an hour of weightlifting   It was pretty intense to say the least	weightlifting	Bench press
i did bench press 135lbs for 8 reps i felt tired	bench press	Bench press
I did five sets of bench press My chest felt like it was filled with blood	bench press	Bench press
I do dips daily . I feel strong after doing dips	dips	Bench press
I started working on my Lower chest , with decline bench press after completing my set my chest was pumped and it was of light weight which helped my chest to prepare for big set	decline bench press	Bench press
I worked out chest and did bench press I 'm very sore now , but it feels good	bench press	Bench press
did chest press and felt energized	chest press	Bench press
I just did 3 sets of dumbell chest presses I felt great and my chest is pumped up	dumbell chest presses	Bench press
Bench Press . Barbell Incline The Bench Press is an extremely important upper body exercise i feel good	Bench Press	Bench press
I did bench press for five minutes I felt drained after	bench press	Bench press
I bench press 150 lbs of weight . i felt sore after .	bench press	Bench press
I bench pressed 205lbs today 5 reps x 5 sets Felt a bit tired after the first exercise . Still performed well but no max rep was achieved .	bench pressed	Bench press
I completed 3 sets of 10 reps bench press I need to practice my form more	bench press	Bench press
I was able to bench press three sets of 200 lbs today . Afterwards I felt exhausted .	bench press	Bench press
I swam fifteen push ups I felt great	push ups	Bench press
I just benched 150 pounds . I am worn out !	benched	Bench press
I just did 3 sets on the bench press . I am weak .	bench press	Bench press
I did mostly strength training including bench press after I was done I felt pump up	bench press	Bench press
I bench pressed a hundred and fifty pounds My arms feel numb	bench pressed	Bench press
bench press on flat bench . very tired	bench press	Bench press
I just completed a set of reps on the bench press This is the most I have ever bench pressed- this is great .	bench press	Bench press
I did the dumbell bench press . I felt like moving up 5 on the 4th set .	dumbell bench press	Bench press
My second workout was a weightlifting rotation I felt good but I am going to be sore .	weightlifting	Bench press
I did bench press at 185 pounds   My chest has gotten stronger	bench press	Bench press
Weights - Chest A little tired , but good workout .	Weights	Bench press
I just bench pressed I felt sick	bench pressed	Bench press
I dumbbell pressed for 10 minutes .   I felt powerful .	dumbbell pressed	Bench press
I just finished bench pressing for 20 minutes . I feel very strong .	bench pressing	Bench press
I benched 225 pounds for one rep I was pumped	benched	Bench press
Bench Press Felt like i was struggling but felt a sense of accomplishment immediately after	Bench Press	Bench press
I did three sets of bench press . I feel it was too easy .	bench press	Bench press
I DID A CHEST WORKOUT IN THREE HOURS MIND RELAXATION	CHEST WORKOUT	Bench press
Bench press , I felt really good after the chest pump	Bench press	Bench press
I did the bench press class at the gym today I felt very tired .	bench press	Bench press
I lifted weights for an hour . I felt very strong after the workout .	lifted weights	Bench press
Bnech presses was one of my first workouts . I felt sore because I had n't done them in a long time .	Bnech presses	Bench press
I did 10 push ups on a workout mat . I felt the pain in my arms and chest .	push ups	Bench press
I did 5 sets of 5 on the bench press at a light weight . It felt good .   I could have gone heavier .	bench press	Bench press
I did bench press and my chest was sore the next morning .	bench press	Bench press
I doing Bench press It fits me a lot	Bench press	Bench press
I just finished a bench press My elbows were sore .	bench press	Bench press
Bench pressing 25 pounds I felt invigerated	Bench pressing	Bench press
I did 30 mins of yoga . I felt very relieved and my muscles were feeling strong .	yoga	Yoga
""""""" I did a workout from my yoga app . """" """" My muscles feel better . """""""	yoga	Yoga
I did yoga for an hour .   I feel incredibly relaxed and exhausted .	yoga	Yoga
I spent a hour doing yoga I feel like I 'm dying- every muscle hurts	yoga	Yoga
I did a 30 minute yoga workout today It felt great and allowed me to work out some aches and pains .	yoga workout	Yoga
I did yoga for an hour . I feel loosened up .	yoga	Yoga
I just spent an hour doing yoga . I felt relaxed and at peace .	yoga	Yoga
I did booty yoga at the gym today for 45 minutes . I feel like I need to work out more , I am out of shape .	booty yoga	Yoga
I did an hour of yoga I felt really limber and proud !	yoga	Yoga
I did a slwo yoga class I feel so relaxed and good after all the stretching .	yoga	Yoga
I just finished a 45 minute yoga session . I feel so much more relaxed !	yoga	Yoga
I took a yoga class at the gym today . I feel relaxed and more energised .	yoga class	Yoga
I did a yoga routine for one hour . It was very difficult and my muscles hurt afterward .	yoga routine	Yoga
I took a hot yoga class I felt exhausted after the class	yoga	Yoga
I did a 30 hour yoga session . I felt relaxed but toned .	yoga	Yoga
I just tried yoga for the first time . I feel refreshed and healthy .	yoga	Yoga
I do 15 minutes of yoga .   I feel warmed up and stretched after it .	yoga	Yoga
I just did a 40-minute yoga session . It was wonderful !	yoga	Yoga
I just did 40 minutes of yoga . I feel refreshed .	yoga	Yoga
I just did yoga for 30 minutes . My muscles were sore .	yoga	Yoga
I did yoga for an hour   The start I was stiff but felt better after	yoga	Yoga
I did yoga I felt refreshed	yoga	Yoga
Yesterday I tried Yoga for the first time . I am not flexible at all !	Yoga	Yoga
I did a hour heated yoga class today It was exhausting	heated yoga	Yoga
I completed 30 minutes of yoga I felt relaxed and flexible	yoga	Yoga
I just did an hour of yoga . It was very relaxing .	yoga	Yoga
I just did 30 minutes of yoga . I feel emotionally relieved !	yoga	Yoga
I did hot yoga for 60 minutes . It felt great and I need the warmth and sweat in the middle of winter .	yoga	Yoga
I did a one hour yoga session . I was really relaxed .	yoga session	Yoga
I did downward facing dog It hurt because I have n't done any yoga in weeks	downward facing dog	Yoga
I did thirty minutes of yoga I feel so relaxed	yoga	Yoga
I did yoga I was relaxed	yoga	Yoga
I did one hour of yoga I felt fantastic	yoga	Yoga
I did yoga for one hour . I felt flexible .	yoga	Yoga
I did 20 minutes of yoga . I feel calm and rejuvenated .	yoga	Yoga
I did yoga for one hour today I feel sore	yoga	Yoga
i did Adho Mukho Svanasana it was not that difficult and was relaxing .	Adho Mukho Svanasana	Yoga
I just completed a Yoga workout I feel so relaxed and limber after the workout .	Yoga	Yoga
I did yoga for an hour , and I felt refreshed .	yoga	Yoga
I just took a hot yoga class . It was challenging , but I feel more flexible already	hot yoga class	Yoga
I did a Barre based workout I felt challenged but stretched out after	Barre	Yoga
I did yoga for 22 minutes I felt more flexible	yoga	Yoga
I did Yoga it feel good	Yoga	Yoga
I went to a flow yoga class I felt at peace !	flow yoga class	Yoga
I went to a yoga class for an hour . I felt relaxed and accomplished .	yoga	Yoga
i did yoga(suryanamaskar ) at first i felt my body not adjusting and not very flexible but later i felt good .	suryanamaskar	Yoga
I just finished a yoga with addriene video relaxed and happy	yoga	Yoga
I did yoga for 15 minutes I felt good but confused	yoga	Yoga
I just spent one hour in a yoga class I felt a bit intimidated at first because this was my first class . However , at the end I felt great .	yoga class	Yoga
I spent forty five minutes on the exerciese bike . My legs felt like jello .	exerciese bike	Yoga
I just did 30 minutes of yoga . I feel relaxed and less stressed out now .	yoga	Yoga
I did yoga from a video on tv . I was so sore from all the stretches	yoga	Yoga
I attended a three - hour yoga workshop I felt relaxed but exhausted .	yoga	Yoga
I did yoga I feel stretched out	yoga	Yoga
I did yoga this afternoon It was relaxing	yoga	Yoga
I did a yoga class for almost 2 hours . I felt relaxed , proud and capable .	yoga class	Yoga
I did 30 minutes stretches I was so sore but   I kept it up	stretches	Yoga
I did yoga for one hour I felt fantastic	yoga	Yoga
I did yoga I feel relaxed and calm	yoga	Yoga
I just did Vinyasa yoga for 45 minutes . I felt so relaxed afterwards !	Vinyasa yoga	Yoga
I just did hot yoga for an hour ! I feel so sweaty !	hot yoga	Yoga
i took a hot yoga class today i sweated buckets !	hot yoga	Yoga
I went to yoga class . I am tired , but feel strong and more relaxed	yoga	Yoga
I just did an 30 minute yoga video from youtube . My flexibility is horrible , my muscles are very tight .	yoga	Yoga
I just did 30 yoga poses . I felt relaxed and focused after completing all of the poses .	yoga	Yoga
I did an hour of yoga . I felt shaky , but proud of myself .	yoga	Yoga
I did my first yoga session I was wiped out	yoga	Yoga
I just did yoga I felt great !	yoga	Yoga
I just did yoga for 30 minutes I feel so refreshed and energized now	yoga	Yoga
I did ten minutes of yoga I felt relaxed and less tense	yoga	Yoga
I did yoga for 30 mins felt relaxed	yoga	Yoga
In spite of doing breathing exercise there was difficulty in breathing	breathing exercise	Yoga
I just did yoga . I feel relaxed .	yoga	Yoga
i did a hot yoga class i felt tired	yoga	Yoga
I participated in a core yoga class I wo n't be able to move tomorrow	core yoga	Yoga
I did yoga on Youtube It was calming but challenging	yoga	Yoga
I just finished yoga class I 'm exhausted	yoga	Yoga
60 minute yoga It was very enlightening	yoga	Yoga
I just do yoga . I felt fabulous	yoga	Yoga
I did a 30 minute yoga video this morning .   I felt like my body relaxed .	yoga video	Yoga
I did yoga by following along with a YouTube video .   I felt accomplished as I completed the workout .	yoga	Yoga
I just did an hour of hot yoga . I felt so relaxed .	hot yoga	Yoga
I finished thirty minutes of yoga ! I feel so relaxed !	yoga	Yoga
I did a 1-hour yoga class I felt energized and confident	yoga	Yoga
I just did some yoga exercise   It was very challenging	yoga exercise	Yoga
I did one hour of a yoga class . I feel relaxed , calm , and happy .	yoga	Yoga
I do 20 minutes mediation daily . I felt relax .	mediation	Yoga
I did 30min of yoga and was quite bored from it .	yoga	Yoga
i will do yoga i feel fresh after my workout .	yoga	Yoga
I just did some intense yoga exercises and I feel so out of shape !	yoga	Yoga
I practiced downward dog yoga pose . I have more work to do .	downward dog	Yoga
I did 20 minute beginner yoga .   Back hurting , but otherwise OK .	yoga	Yoga
I did an hour of yoga . I feel great !	yoga	Yoga
I just did yoga for 1 hour I feel relaxed and limber	yoga	Yoga
I went to hot yoga and felt super relaxed after .	yoga	Yoga
I did 30 minutes of yoga . I felt relaxed and rejuvenated after .	yoga	Yoga
I went to a yoga class at the gym this morning . I felt energized leaving the gym .	yoga class	Yoga
I did yoga for an hour . It was refreshing .	yoga	Yoga
I performed exercises in a home aerobics video . I feel like I 'm going to be sore tomorrow .	aerobics video	Aerobics
I did aerobics for thirty minutes . I feel energized .	aerobics	Aerobics
I did aerobics . I could n't finish .	aerobics	Aerobics
I did a 45 minutes step class . The workout felt great while doing it but now my legs feel weak .	step class	Aerobics
Endurance , or aerobic These activities increase my breathing and heart rate .	Endurance	Aerobics
I did aerobics for 30 minutes I felt very light	aerobics	Aerobics
I did cardio in my bedroom this morning for 30 minutes . I felt so invigorating afterward !	cardio	Aerobics
I took a class in aerobics . I felt good while doing the exercise and sore after exercise .	aerobics	Aerobics
I am doing yoga daily It gives me endurance , strength , balance and flexibility	yoga	Aerobics
I just completed a aerobics class . This class was fun and I sweated alot !	aerobics class	Aerobics
After doing aerobics for 30 minutes I was feeling fatigue	aerobics	Aerobics
i basically just did water areobics i felt like a 55 year old woman	water areobics	Aerobics
I did an at home aerobics cardio burning exercise video . I felt exhausted but accomplished .	aerobics	Aerobics
I just did 30 minutes of Dancer - cise I felt the burn and am sweaty and tired .	Dancer - cise	Aerobics
I did stretching exercises for 15 mintes I felt more relaxed after this workout	stretching	Aerobics
I bounced on the yoga ball for an hour . I felt accomplished .	bounced	Aerobics
I exercised in a step aerobics class today at the YMCA .   I felt really energized and strong after the class .	step aerobics	Aerobics
I did a aerobic dance class in everyday . It gives fitness and i felt increase my breathe .	aerobic dance	Aerobics
I just did a 50 minute aerobic class . I felt so weak and out of shape .	aerobic	Aerobics
I danced for 2 hours . I was pleased .	danced	Aerobics
I did a jump rope routine for 20 minutes I broke a sweat and feel loose	jump rope routine	Aerobics
I just finished a one hour water aerobics class . I felt light , like all the pressure was taken off my body during the session .	aerobics	Aerobics
I spent 30 minutes playing AudioShield . I feel pumped up !	AudioShield	Aerobics
I did aerobics for an hour .   I felt tired .	aerobics	Aerobics
Aerobic activities increase your breathing and heart rate . I felt energetic .	Aerobic	Aerobics
Zumba for 6 hours Ligt on my feet	Zumba	Aerobics
I skipped for 30 minutes .   I feel athletic .	skipped	Aerobics
I jumped rope . I felt winded .	jumped rope	Aerobics
I participated in a group 30 minute aerobics class toda . It was a real challenge , I sweated for 20 minutes but felt amazing when it was over .	aerobics	Aerobics
I did 50 sit ups and 50 leg cruches I felt tired and worn out .	did	Sit Ups
I did 100 sit ups at the gym today It was exhausting !	sit ups	Sit Ups
I did 100 situps . I could really feel the burn .	situps	Sit Ups
I did ten weighted sit ups ! I hope I can improve	sit ups	Sit Ups
I do sit ups It burns my stomach in a good way	sit ups	Sit Ups
50 crunches abs are burning feels good tho	crunches	Sit Ups
I did a 10 minute ab workout I felt really out of shape	ab workout	Sit Ups
I did 200 situps . I feel like I got run over by a truck .	situps	Sit Ups
I did 30 crunches . I felt sore but accomplished .	crunches	Sit Ups
I do 10 sit ups and I feel accomplished but also very tired .	sit ups	Sit Ups
I did 3 sets of 25 sit ups in the morning . My stomach was on fire and I felt really out of shape .	sit ups	Sit Ups
I just did 100 sit ups at the gym . My abdomen aches and I 'm a bit shaky .	sit ups	Sit Ups
i did 40 sit ups my abs are killing me	sit ups	Sit Ups
I did one hundred sit - ups . My stomach muscles are burning .	sit - ups	Sit Ups
i just did 100 sit ups my abs are burning	sit ups	Sit Ups
I have just completed 100 sit ups . I felt out of shape and need improving .	sit up	Sit Ups
situps tired	situps	Sit Ups
I just did 100 sit - ups ! My stomach hurts so much !	sit - ups	Sit Ups
I did 10 situps . I realized I 'm not who I once was .	situps	Sit Ups
I did a 30min abs workout . It was really hard .	abs workout	Sit Ups
I did 10 sit - ups . I feel out of shape .	sit - ups	Sit Ups
I did 50 sit - ups I need to start doing more core workouts !	sit - ups	Sit Ups
I did three reps of 15 sit ups My abs were on fire .	sit ups	Sit Ups
I did 15 situps . I feel tired .	situps	Sit Ups
I did 10 sit ups today . I feel like I 'm as out of shape as most 90 year olds .	sit ups	Sit Ups
I just completed situps .   I have a weak core .	situps	Sit Ups
I did 30 squats in the morning It was overwhelming	squats	Sit Ups
I did 5 sit ups today .   I feel real tired and drained .	sit ups	Sit Ups
I beat my record , doing 100 sit ups . I feel ABSolutely accomplished !	sit ups	Sit Ups
Sit up and was exhausted	Sit up	Sit Ups
In my living room , I did 20 sit ups on the floor . I felt strained and out of shape .	sit ups	Sit Ups
I did some sit ups I totally felt the burn . Hurt my stomach in a good way	sit ups	Sit Ups
did 100 situps in a row , it burns	situps	Sit Ups
I did 100 situps . It was kinda hard and felt kinda sick .	situps	Sit Ups
I did 100 situps I felt accomplished .	situps	Sit Ups
I did 100 situps . My stomach is on fire .	situps	Sit Ups
I did 3 sets of 20 sit ups I felt really out of shape	sit ups	Sit Ups
I did some sit ups on the floor mat today . I felt very tired after I was finished .	sit ups	Sit Ups
I did 40 situps . This felt good in my abs .	situps	Sit Ups
Sit ups for 120 times It just killed my knee joints	Sit ups	Sit Ups
i did 20 sit ups i felt terrible	sit ups	Sit Ups
I did sit ups Felt good about it	sit ups	Sit Ups
I did two hundred sit - ups . I feel weak and rather hungry .	sit - ups	Sit Ups
I just finished doing a total of 160 situps . I barely finished and my middle feels sore !	situps	Sit Ups
I did 20 sit - ups . It was relaxing afterwards .	sit - ups	Sit Ups
I did fifty sit ups My stomach hurt	sit ups	Sit Ups
I did 100 situps . I felt accomplished .	situps	Sit Ups
i made 30 sit ups   it was painful	sit ups	Sit Ups
I did 200 situps and my back became sore , so I felt bad	situps	Sit Ups
I did a few sets of stomach exercises   I felt some pain	stomach exercises	Sit Ups
I did 40 sit ups in 2 minutes . I am really out of shape .	sit ups	Sit Ups
I did 4 sets of butterfly sit - ups . My abs were on fire .	butterfly sit - ups	Sit Ups
I did 30 situps . I 'm starting to feel the burn .	situps	Sit Ups
I just did 20 situps ! I felt accomplished .	situps	Sit Ups
I did 10 sit ups . It really hurt .	sit ups	Sit Ups
I played golf for 4 hours and was energized	golf	Golf
I played golf for an hour today and walked the course .   It felt good getting out in the fresh air and I feel rejuvenated .	played golf	Golf
I played 18 holes of golf I feel happy to have played so long	golf	Golf
I PLAYED A GOLF AND I FEEL VERY DISGUST	GOLF	Golf
I played golf with my friend I felt better after the work out because i burned calories .	golf	Golf
I just jogged on the treadmill for 45 minutes1 My legs are so sore .	jogged	Jogging
I ran a mile on the treadmill I was super winded	ran	Jogging
I did a treadmill run . I felt good going in to the jog . It was an augmented reality treadmill .	run	Jogging
I went for a jog I was exhausted	jog	Jogging
I jogged with my dog around the neighborhood I felt calm and purposeful	jogged	Jogging
I jogged around my neighborhood today . I felt so much better after	jogged	Jogging
I did jogging Feeling relaxed	jogging	Jogging
I jogged 1 mile I felt out of breath	jogged	Jogging
I ran three miles . I am winded .	ran	Jogging
I jogged for 2 miles . I felt very stiff .	jogged	Jogging
cycling loss weight	cycling	Jogging
I jogged for 20 minutes I was out of breath but determined to jog tomorrow	jogged	Jogging
I jogged for 45 minutes around the nearby trail My knee was hurting but I would do it again tomorrow	jogged	Jogging
I JOGGED 3.5 MILES THIS AFTERNOON I FEEL ENERGIZED AND HUNGRY NOW	JOGGED	Jogging
I jogged three miles working out to a video on YouTube . I felt energized as I went along .	jogged	Jogging
I just ran a mile on the beach I feel refressed but a little tired	ran	Jogging
I jogged for two miles . I feel terrific .	jogged	Jogging
I jogged 3 miles today I am totally wiped out .   I am not in good shape .	jogged	Jogging
I just jogged 3 miles I am so out of shape and winded ! ! !	jogged	Jogging
I jogged for 45 minutes . I 'm tight and worn out .	jogged	Jogging
I am going on a run . It felt like a struggle to push forward .	run	Jogging
ran a mile it was hard	ran	Jogging
I jogged on the treadmill for 30 mintues I 'm really out of breathe	jogged	Jogging
I went for an hour jog Afterwards I actually felt energetic	jog	Jogging
Ran three miles on the treadmill .   My knee was hurting .	Ran	Jogging
I ran 1 mile . Had a hard time breathing after .	ran	Jogging
I do jogging I felt now ok	jogging	Jogging
I ran a mile . I felt exhausted .	ran	Jogging
I went jogging on the park trail . I felt tired .	jogging	Jogging
I jog this morning for 1 hour I felt very energetic after the exercise	jog	Jogging
I ran for 30 minutes tired by proud	ran	Jogging
I go for Jogging Its very tired	Jogging	Jogging
I just jogged for 5 miles . I am exhausted .	jogged	Jogging
I just jogged for a mile . I felt totally winded .	jogged	Jogging
I jogged 30 minutes around my neighborhood . I am tired and sweaty .	jogged	Jogging
i jogged for 45 minutes non stop it was tiring	jogged	Jogging
I jogged for 15 minutes . My lungs were burning and my back aches .	jogged	Jogging
I jogged for 10 minutes It was exhausting	jogged	Jogging
Jogging with the dog Calves felt sore	Jogging	Jogging
I jogged around the block I felt refreshed	jogged	Jogging
I jogged for 15 minutes . I felt my heart beating fast as I was jogging .	jogged	Jogging
Jogging   felt better and satisfied	Jogging	Jogging
I jogged one mile Very Tired	jogged	Jogging
I jogged 3 miles today . I felt energized after my walk .	jogged	Jogging
I was jogging intensely on the treadmill I felt very delighted after doing this	jogging	Jogging
I went for a brisk jog . I realized how low my cardiovascular endurance is .	jog	Jogging
I jugged almost the entire field Felt so weak	jugged	Jogging
I went jogging I hated it	jogging	Jogging
I jogged 3 miles . My legs and lower body was sore .	jogged	Jogging
I jog about half a mile on my second workout . I felt physically strong after my second workout .	jog	Jogging
I finished a 3 mile jog . It was hard , but I',m glad I did it .	jog	Jogging
I just jogged 5 miles   My legs feel rubbery	jogged	Jogging
run three miles on track Terrible	run	Jogging
I went on a 5k run it was refreshing	run	Jogging
I jogged around the lake this morning .   I felt great afterwards .	jogged	Jogging
I prefer to jog in the morning .   I feel energetic and boosted for doing my day 's work after jogging .	jog	Jogging
I did a 10 minute jog . I was terrible exhausting .	jog	Jogging
JOGGING MORNING JOGGING IS BEST	JOG	Jogging
early morning first warmup its hardly pain	warmup	Jogging
I used the treadmill at the gym today . My legs feel like noodles .	treadmill	Jogging
went for run intense	run	Jogging
I jogged for 30 minutes . I feel tired and my legs are shaking .	jogged	Jogging
I jogged 800 meters to my friends house and back . I felt relaxed and in peace , breathing in and out as i was witnessing the beautiful environment .	jogged	Jogging
I jogged 2 miles around the lake .   I feel good !	jogged	Jogging
A two mile jog uphill . I felt accomplished that I made it that far .	jog	Jogging
I jogged one mile . I felt totally exhausted and shakey .	jogged	Jogging
I jogged on the beach My legs are exhausted and shaky	jogged	Jogging
I ran for 30 minutes I felt great doing it	ran	Jogging
I jogged for a mile I felt exhausted	jogged	Jogging
i feel happy while jogging   i feel fresh	jogging	Jogging
I do Jogging I felt Very Tired	Jogging	Jogging
I jogged around the neighborhood . I felt amazing !	jogged	Jogging
i will do running it makes me energetic	running	Jogging
Jogging in place 2 minutes Breathless for a couple of minutes	jogging	Jogging
i went for a jog being out of breath is painful	jog	Jogging
Today I Jogged for 1 hour I felt super out of breath and out of shape .	Jogged	Jogging
I ran 2 miles I felt tired and breathless	ran	Jogging
I jogged through my neighborhood . I felt refreshed .	jogged	Jogging
I just ran one mile . I m very tired	ran	Jogging
I jogged at the parked for three miles . I felt good once I started to jog and warmed up .	jogged	Jogging
Jogging with dog Ready for the day	Jogging	Jogging
I went jogging outside for 30 minutes . I felt refreshed afterwards .	jogging	Jogging
I just jogged around the corner   i Felt very tired during this exercise	jogged	Jogging
i jogged for thirty minutes i felt great	jogged	Jogging
I jogged for about a half - mile . I thought I was going to pass out .	jogged	Jogging
I jogged for 20 minutes . I felt tired but accomplished !	jogged	Jogging
jogging . i feel shortly i get tired after going to jogging  	jogging	Jogging
I jogged on the treadmill for 2 miles . I was tired and very relieved when the workout was finished .	jogged	Jogging
I just ran five miles It was terrible !	ran	Jogging
I WENT JOGGING around the block I felt like my legs were jello	JOGGING	Jogging
I ran 3 miles . I was totally worn out .	ran	Jogging
Jogged for 3 miles   it felt me so tired	Jogged	Jogging
I just jogged 10 miles ! I felt tired .	jogged	Jogging
I ran around my neighbor hood 2 times I felt good after the run ,	ran	Jogging
I ran 2 miles in the estate It was horrible	ran	Jogging
I took my dog for a jog .   I felt worn out from trying to keep up with my dog .	jog	Jogging
I jogged two laps and was exhausted and worn out .	jogged	Jogging
I jogged for two miles and felt great afterwards .	jogged	Jogging
I ran a mile I felt proud	ran	Jogging
Jogged for 1 mile . I felt exhausted .	Jogged	Jogging
After jogging for twenty minutes , I felt like I could fall asleep on the ground .	jogging	Jogging
I jogged on the treadmill for 15 minutes . I feel energized after jogging .	jogged	Jogging
I ran three miles on sidewalks . I felt tired .	ran	Jogging
I jogged around my drive way and I felt tired after .	jogged	Jogging
I jogged 2 miles . I feel refreshed .	jogged	Jogging
I took a jog I felt tired .	jog	Jogging
Stretching I did a few stretches as well I felt as if I was getting my stretches done right	Stretching stretches	Stretching
twisted body for stretching could feel it but still felt good stretching	stretching	Stretching
Morning stretches Better able to function	stretches	Stretching
I alternately touched my toes with opposite hands twenty times on each side . When I was doing this exercise I began to feel winded , and a bit stressed .	touched my toes	Stretching
I stretched for 10 minutes and I feel like it helped	stretched	Stretching
I spend 1 hours stretching I feel so sore !	stretching	Stretching
I did an exercise called Body Groove . I was sore but it felt good .	Body Groove	Stretching
I stretched for an hour today . I feel much lighter and accomplished .	stretched	Stretching
I did a 30 minute yoga video My glutes have really loosened up	yoga	Stretching
I just stretched for 30 minutes .   It felt wonderful !	stretched	Stretching
I snowshoed for 1 hour . I felt happy to be outside .	snowshoed	Other
Two miles in the new wheelchair .   I have aches in muscles I did n't know existed .	wheelchair	Other
I played an hour of netball game and though I was exhausted afterwards it was fulfilling .	netball game	Other
I did a 2 sets of resistance band walks My thighs are shaky	resistance band walks	Other
I went surfing for 3 hours Shoulders are a bit tired , but my legs feel great	surfing	Other
I used my ab roller for 15 minutes straight . I was so fatigued afterwards !	ab roller	Other
I just hopped like a frog .   I feel really burnt out .	  hopped	Other
I worked a free hand exercise It was very useful to me	free hand	Other
i played an hour of beat saber to warm up I felt great , limber and warmed up .	beat saber	Other
I played racquetball for a couple of hours . I 'm felt great , but could n't wait to take a shower .	racquetball	Other
I did strength training . I feel weak .	strength training	Other
This morning I did the obstacle course at the naval base faster than any of my workout partners . I felt like my training was finally paying off .	obstacle course	Other
I do hydrogymnastics three times a week , the exercises are simple . However , they are tiring .	Hydrogymnastics	Other
t bar rows good back workout	rows	Other
10x20 yd sled pushes Felt good overall , pace dramatically slowed last 3 reps	sled pushes	Other
calf raises not too fatigued but sore in my calves	calf raises	Other
I did 20 second wall sits It made my legs burn	wall sits	Other
I did two hours of gardening . I feel accomplished .	gardening	Other
I felt very tired after doing some squat thrusts for 30 minutes .	squat thrusts	Other
This morning I did a strenuous shoulder workout   and now I m sore	shoulder workout	Other
I raked all the leaves I feel motivated	raked	Other
I jumped on the trampoline for 20 minutes . I felt good .	jumped	Other
I competed at a Cheer competition today . I felt rejuvenated after .	Cheer	Other
I just played handball . I am energetic .	handball	Other
I did 30 minutes of Wii Fit exercise . I was very tired when I was done .	Wii Fit	Other
jumping feel better	jumping	Other
I stretched my legs for about ten minutes I feel great and ready for my work out	stretched	Other
Did 4 sets of hills at the stadium , from track to top bleachers Really burned my calves , but endurance - wise it was great	hills	Other
I hula hooped or twenty minutes . My sides and my stomach really hurt and I feel tired .	hooped	Other
Did 2 sets 12 reps shoulder press at 15lbs Really hard , left shoulder hurts	shoulder press	Other
I made 3 sets of parallel bar dips I 'm really tired	parallel bar dips	Other
I walked along a balance beam back and fortj I felt firm and loose , and determined to maintain my balance .	balance beam	Other
I cleaned the house for 3 hours I am worn out .	cleaned	Other
I rode the stationary bike at moderate intensity for an hour My legs were tired but cardio wise i was fine	stationary bike	Other
i tried a barre workout my muscles felt the burn	barre	Other
I also did farmer walks today with my water jugs . Been exhausted all day , killed it this morning .	farmer walks	Other
I followed a workout video . My stamina is very low .	workout video	Other
I did an hour of callenetics . I feel more flexible .	callenetics	Other
I do warm up before match    i feel brisk	warm up	Other
I do functional training every day and I get exhausted when I 'm done .	Functional Training	Other
I completed one video workout .   It felt really good to work up a sweat .	video workout	Other
i feel energized , i just shot 3 rounds of archery	archery	Other
I played softball for three hours . I was exhausting .	softball	Other
I did a swiss ball hamstring curl today . I felt unbalance .	swiss ball hamstring curl	Other
I spent 45 minutes doing pool aerobics . I felt great after this workout .	pool aerobics	Aerobics
I participated in a Jazzercize class . I felt excited and revived .	Jazzercize	Exercise Class
I took an hour long hip - hop dance class . I felt incredible and had so much fun because it was a high energy environment !	hip - hop dance class	Exercise Class
I just did a 3 hour spin class I am dead tired	spin class	Exercise Class
i just did a cardio for 30 minutes i felt amazing	cardio	Exercise Class
I did a 15 minute step workout . I am not as fit as I thought I was .	step workout	Exercise Class
I attended two one - hour dance classes . I felt empowered .	dance class	Exercise Class
I finally practiced doing pilates this morning . It really made me feel so weak !	pilates	Exercise Class
I rode the spin bike for an hour . I felt great !	spin bike	Exercise Class
I attended a spin class My legs are sore	spin class	Exercise Class
I did 30 minutes in a spin class . It was hard but I felt great after !	spin class	Exercise Class
I did stretching exercises I felt relaxed	stretching	Exercise Class
I did a barre workout video .    My legs were shaking at the end .  	barre	Exercise Class
I did   my spin bike for 30 minutes . I felt tired but happy I fnished .	spin bike	Exercise Class
I took a one hour spinning class .   I feel refreshed and energized .	spinning	Exercise Class
I went to Curves circuit , where I 'm a member .   I typically enjoy the Curves circuit , but I was very annoyed by an employee .	Curves circuit	Exercise Class
I exercised for 15 minutes by dancing to fast music . I felt great during the dancing and had fun doing it .	dancing	Exercise Class
I just took an hour long spin class , and I feel energized !	spin class	Exercise Class
I took a one hour muscle pump class It was challenging !	muscle pump class	Exercise Class
I did a Nike workout at the gym . I could feel my muscles .	Nike workout	Exercise Class
I just finished a group barre class . It was exhausting and now I feel sore .	group barre class	Exercise Class
i did cardio i felt refreshed and invigorated before and during	cardio	Exercise Class
I took a 45-minute barre class . I was exhausted !	barre class	Exercise Class
I prefer doing pilates in the evening after work . I feel relaxed and light after my evening workout .	pilates	Pilates
I did a 30 minute pilates video this morning . I realized how tight my muscles are , I need that stretching and movement !	pilates	Pilates
I just did pilates I 'm out of shape	pilates	Pilates
I did Pilates for 20 minutes I felt great	Pilates	Pilates
I did thigh toning pilates for 20 minutes I felt great and tired altogether	thigh toning pilates	Pilates
I did an hour long pilates class I feel relaxed but sore	pilates	Pilates
I did pilates . I felt relaxed .	pilates	Pilates
I did a one hour pilates class and felt energized but sore .	pilates class	Pilates
I did an hour of ballet boot camp . I feel like I am not where I should be fitness wise .	ballet boot camp	Pilates
I just completed a 30 minute Pilates video . I am now stiff and sore .	Pilates	Pilates
We just completed our first hell hike . It was long and hard , but we feel great .	hell hike	Hiking
I went on a hiking trial and walked for 45 minutes . I felt very refreshing .	  hiking trial	Hiking
I just went on a 5 hour hike . It felt refreshing and exciting .	hike	Hiking
I hiked 10 miles up a mountain ridge . I was exhausted , but never felt so alive .	hiked	Hiking
Went for a hike Felt exhausted	hike	Hiking
I hiked three miles and felt awake , connected to nature and happy .	hiked	Hiking
I walked three miles on the mountain trail this morning . I felt energized !	walked	Hiking
i hiked 4 miles of the trail it felt relaxing and peaceful	hiked	Hiking
I hiked for an hour and a half I felt invigorated	hiked	Hiking
I just went for a two mile hike . I feel exhausted .	hike	Hiking
I went for a hike .   My calfs are on fire .	hike	Hiking
I just hiked 3 miles with my weighted vest . I felt really tired afterwards	hiked	Hiking
I hiked 2 miles to the put in I was tired but excited	hiked	Hiking
I hiked 6 miles .   I felt really sore afterwards !	hiked	Hiking
I did a four mile hike . I 'm exhausted .	hike	Hiking
Hiked Pisgah , 1:45 It was hot .	Hiked	Hiking
I just finished a 3 mile hike . It was great !	hike	Hiking
We just completed our second hell hike . It was not as bad as the first one , but we have a long way to go . Man , we are tired !	hell hike	Hiking
I just hiked 4 miles in the forest . I felt great	hiked	Hiking
I just hiked 7 miles , uphill , one way ! I feel amazing !	hiked	Hiking
I just hiked 2   and a half miles I feel refreshed	hiked	Hiking
I hiked from my house to the top of Spencer Butte , about 10.5 miles one way . I felt tired and my feet hurt , but the experience was invigorating .	hiked	Hiking
I just hiked one mile . I feel energized .	hiked	Hiking
Went on a 3 mile hike . Tired and weak .	hike	Hiking
I took a 2 hour hike It was invigorating	hike	Hiking
I just completed a one hour hike I feel great , the last 10 mins was tiring	hike	Hiking
I went for a hike and am totally exhausted	hike	Hiking
I walked 5 miles . After the workout , I felt tired but happy .	walked	Hiking
MY SECOND WORKOUT IS WEIGHT LIFT . AFTER A DAYS , ITS REALLY CHANGE OUR BODY WEIGHT	WEIGHT LIFT	Hiking
I hiked a mild trail i feel free	hiked	Hiking
I hiked through the hills today . I enjoyed the scenery , but my legs feel like rubber .	hiked	Hiking
I hiked with my dog . I felt refreshed .	hiked	Hiking
I hiked up a hill and felt very strong !	hiked	Hiking
I just completed a 5 mile fit walk exercise video .   I was really exhausted and beat after that !	walk	Hiking
Went for a hike Felt Tired	hike	Hiking
I hiked up a long trail today . My legs are killing me .   I am tired .	hiked	Hiking
I hiked for three hours and felt tired during and after .	hiked	Hiking
I just walked 5 miles up a moutain It was very hard	walked	Hiking
I just hiked 15 miles . I am worn out !	hiked	Hiking
I like long hikes in the woods with my dog . These make me feel refreshed and help unwind .	hikes	Hiking
I hiked 12 miles today . I feel accomplished !	hiked	Hiking
I went for a five hour hike . The last stretch was rough on my back .	hike	Hiking
I hiked up a moutain path for one hour . I feel invigorated by the fresh moutain air and am ready for more .	hiked	Hiking
I hiked to the top of that mountain .   It felt exhilarating to climb that high .	hiked	Hiking
I walked a mile . I felt warmed up .	walked	Hiking
I hiked for 60 minutes with my dog and felt really perky throught out and after it .	hiked	Hiking
I hiked 15 miles . I felt tired .	hiked	Hiking
I went on a 8 mile hike to a secret waterfall .   I felt hot and tired but very strong and energized at the same time .	hike	Hiking
I went for a 6 mile hike . I am tired and achey , but feeling good !	hike	Hiking
I hiked 3.5 miles at Pinnacle Peak Trail . It was tough but invigorating .	hiked	Hiking
I played basketball for the last 2 hours with my friends . It felt amazing I can't wait to do it again ,	played basketball	Basketball
I played basketball after work . I am so exhausted !	basketball	Basketball
i play a basketball three hours and i felt so tired .	basketball	Basketball
pick - up basketball Sore , need to stretch more before .	basketball	Basketball
I played a pick - up game of basketball .   I felt great after the game .	basketball	Basketball
I PLAYED BASKET BALL ENJOY THE GAME AND FITNESS THE BODY	BASKET BALL	Basketball
I played a 30 minute pick up basketball game My breathing was heavy for five minutes after the game	basketball game	Basketball
I played basketball for three hours . I felt out of breath .	basketball	Basketball
I played a whole day of basketball and I feel sored .	basketball	Basketball
I played two games of half - court basketball . I feel great and need to play more often .	played	Basketball
i played basketball for an hour i was very tired	basketball	Basketball
I played a three hour basketball game.i was so exhausted after ! .	basketball game	Basketball
I played some basketball today . I felt stiff and lacking coordination .	basketball	Basketball
I played a three hour basketball . I felt strong	basketball	Basketball
I played an hour of basketball and was tired	basketball	Basketball
I just played basketball for 3 hours . My legs are burning I need to relax .	basketball	Basketball
I played basketball and felt exhilirated .	Basketball	Basketball
I played basketball for 90 minutes . It felt great to break a good sweat !	basketball	Basketball
I played basketball for a half hour . I felt out of shape since I was instantly out of breath .	basketball	Basketball
I played basketball yesterday with my son . I generally felt ok ... I was a little tired but not too bad	basketball	Basketball
i played a game of pick up basketball i am out of shape and my body is not used to the running .	basketball	Basketball
I played in a 3 on 3 basketball game I am tired !	basketball	Basketball
I just played two hours of basketball I felt very tired	basketball	Basketball
I played basketball . I was out of breath .	basketball	Basketball
I played a pick up basketball game . My back and legs were tired I had to take a nap .	basketball game	Basketball
I played basketball for two hours I felt drained after	basketball	Basketball
passing the ball while jumping makes me a good basketball player feel flexible and happy	basketball	Basketball
I played basketball ball for an hour Feeling relaxed	basketball	Basketball
  i played basketball i felt like a champ	basketball	Basketball
Went out shooting some hoops with friends . Need to really work on my shot .	shooting	Basketball
I played a game of basketball with my friends . I 'm so tired .	basketball	Basketball
I played in a competitive basketball game . I felt very winded but great .	basketball	Basketball
I PLAYED BASKETBALL LAST WEEK , I WAS TIRED AFTER TWO GAMES BECAUSE I'M NOT IN GREAT SHAPE ANYMORE .	BASKETBALL	Basketball
I played full court basketball . I felt out of breath .	played	Basketball
I play 2 hours of basketball and i felt tired	basketball	Basketball
I played an hour of basketball . I feel tired and hungry	basketball	Basketball
I played basket ball for 1 hour . I thought I was going to die during the game if I had to run down the gym one more time .	basket ball	Basketball
I played a 30 minute basketball game in the backyard . My legs felt like noodles at the end of the game .	basketball game	Basketball
I just played 1 on 1 basketball for 4 games I am exhausted .	basketball	Basketball
I would run around the soccer field during practice . I felt tired but also excited .	soccer	Soccer
I played soccer for the first time in two weeks . My ankle got swollen but I did enjoy myself .	soccer	Soccer
Just done playing football Feeling tired	football	Soccer
my first exercise would be football , this is easily tracked by using my smart watch to track steps and distances to give my amount of calories burned . i do not even consider this a traditional type of workout as i enjoy it so much .	football	Soccer
I played a two hours tennis soccer I feel relaxed	soccer	Soccer
1.5H soccer practice Physical Pain	soccer	Soccer
I just played soccer for an hour . My knees hurt .	soccer	Soccer
I played soccer for 20 minutes . I felt exhausted and out of shape .	played soccer	Soccer
I played 45 minutes of soccer with my friends   My legs are so tired	soccer	Soccer
I swam for an hour . I feel so relaxed .	swam	Swimming
Just completed 15 lap swim . I felt good after the workout	swim	Swimming
I just swam for 30 minutes I feel so very tired .	swam	Swimming
I swam in the pool for 30 minutes today I felt rejuvenated !	swam	Swimming
I swam in my pool for 20 minutes I was tired .	swam	Swimming
I swam 2 laps I was ecstatic after swimming	swam	Swimming
I swam laps in the pool dizzy during and after	swam	Swimming
I swam 20 laps and I felt energized !	swam	Swimming
I swam for one hour . I feel energized .	swam	Swimming
I just got back from swimming laps at the pool . I forgot how tired I am after the pool .	swimming laps	Swimming
I swimmed the whole pool I felt energized	swimmed	Swimming
I swam a few laps in the pool . My arms are weak , but it was so worth it .	swam	Swimming
I swam 2400 yards . My shoulders felt tight .	swam	Swimming
I swam fifteen laps I felt strong	swam	Swimming
I swam for thirty minutes . I 'm tired and thirsty .	swam	Swimming
I swam 30 laps at my local gym . I could use a nap after that workout .	swam	Swimming
I swam for 30 minutes . I felt nice afterwards !	swam	Swimming
I just swam arcoss the lake . Afterwards I could n't breathe .	swam	Swimming
I swam 50 laps in the pool .   I feel exhausted .	swam	Swimming
I swam for thirty minutes . I felt tired and worn out , but good .	swam	Swimming
swimming gives a lot stress release	swimming	Swimming
I swam twenty laps I feel tired	swam	Swimming
I swam laps for 25 minutes . It was very challenging .	swam	Swimming
I swam 1 mile I felt refreshed after swimming	swam	Swimming
Swimming i feel relaxing	Swimming	Swimming
I went swimming at the Y for an hour . I was tired when I got done swimming .	swimming	Swimming
I swam 10 full laps in the pool . My arms and legs feel like jelly and I just want to sleep now .	swam	Swimming
I swam for 30 minutes . I felt bursting with energy .	swam	Swimming
i swam three kilometer   i feel without energy	swam	Swimming
I swam 20 laps Tired , but was able to complete the workout I set out to	swam	Swimming
I swam in the pool for an hour It was refreshing	swam	Swimming
i used to swim in the early morning it was energetic for me .	swim	Swimming
I swam two miles . I feel terrific .	swam	Swimming
I was swimming for 30 min It felt fulfilling	swimming	Swimming
JUST SWAM MY FIRST 200 METERS I FEEL COMPLETELY ENERGIZED	SWAM	Swimming
I swam 200 laps . I felt winded .	swam	Swimming
Swimming Will feel very fresh	Swimming	Swimming
I went swimming this morning and swam 6 laps without stopping I felt tired , but good after swimming the 6 laps .	swimming	Swimming
I swim daily i get breath relaxation .	swim	Swimming
I just swam from the la jolla cove to the Scripps pier Steady , even pace	swam	Swimming
I went swimming I felt good	swimming	Swimming
Swam pretty fast from the dock to the south bay and back , about one and a half miles . Water was cold so it really felt good to push the swim . Arms are spent !	Swam	Swimming
I swam two miles . I feel excited .	swam	Swimming
I went swimming I love to swim	swimming	Swimming
i just swam 10 laps and i feel super energized	swam	Swimming
i will do swimming i feel fresh .	swimming	Swimming
I did 100 laps in the pool . I am drained and tired .	laps	Swimming
I just swam laps at the pool for 20 minutes . I feel refreshed	swam	Swimming
I went swimming at the pool . It was enjoyable .	swimming	Swimming
I swam 50 meters in the pool . I felt exhausted and out of breath .	swam	Swimming
I went swimming for half an hour felt really good afterwards	swimming	Swimming
I just swam 10 laps in the pool of each style I felt so out of breath !	swam	Swimming
I just swam two miles . I felt great afterwards .	swam	Swimming
I swam three thousand feet and felt totally refreshed !	swam	Swimming
I swam for 30 minutes I felt hungry	swam	Swimming
I swam for twenty minutes . I feel energetic .	swam	Swimming
I swam two laps I felt refreshed	swam	Swimming
I swam a mile . I feel like I 'm made of lead .	swam	Swimming
I swam 2 laps I was tired afterwards	swam	Swimming
I swam forty laps . I felt refreshed and energized .	swam	Swimming
I love to do swimming I feel great	swimming	Swimming
i just swam two laps ! i just ran two miles and i felt refreshed	swam	Swimming
I just swam ten laps I feel great	swam	Swimming
I swam for 1 hour and I am very tired .	swam	Swimming
I swum ten laps in the pool . I felt exhilarated .	swum	Swimming
I did 25 laps in the pool . I felt alittle winded at first but felt great after my swim .	pool	Swimming
I swam for 40 minutes today My legs are sore and tired	swam	Swimming
I swam 50 laps in the pool . My arms and legs are killing me !	swam	Swimming
I swam laps for 30 minutes I felt refreshed	swam	Swimming
I just swam 20 laps I feel my upper arms getting bigger	swam	Swimming
swimming i felt tired	swimming	Swimming
I swam a mile today . I felt exhausted .	swam	Swimming
I swam laps for 30 mins in the Y pool this afternoon . I hate the taste of chlorine !	swam	Swimming
I swam a kilometre and felt pleasantly tired	swam	Swimming
I Have Every Evening I Am Swim In Pool . I Have Very Relax in My Body .	Swim	Swimming
I swam 2 miles . I felt energized .	swam	Swimming
I swam 10 laps I could hardly breath and I was exhausted	swam	Swimming
I just swam 10 laps at the pool . I feel tired .	swam	Swimming
I swam for twenty minutes and I felt like I could hardly breathe .	swam	Swimming
I went swimming for two hours today .   I was exhausted afterwards .	swimming	Swimming
I used skip everday Feels great ! !	skip	Skipping
skipping i feel relax	skipping	Skipping
i do skipping it make me tired	skipping	Skipping
I regularly second workout is Skipping I fell very refresh	Skipping	Skipping
I skip roped for 10 minutes I felt quitting during the workout	skip roped	Skipping
SKIPPING IS ONE OF THE BEST GAME AND EXERCISE . I FEEL WEIGHT LOSS	SKIPPING	Skipping
I do skipping for three months I felt tall	skipping	Skipping
I did a skipping Feeling relaxed	skipping	Skipping
SECOND EXERCISE IS SKIPPING AND I FEEL GOOD BODY MAINTAINING AFTER DOING THAT .	SKIPPING	Skipping
I jumped rope for ten minutes . I felt invigorated .	jumped	Jumping Jacks
I just did a hundred jumping jacks . I think I can do another hundred .	jumping jacks	Jumping Jacks
I did ten jumping jacks . I felt out of breath afterward .	jumping jacks	Jumping Jacks
I did 20 jumping jacks I felt exhausted	jumping jacks	Jumping Jacks
I did twenty five jumping jacks . It sucked .	jumping jacks	Jumping Jacks
I did 20 jumping jacks My heart is racing and I am out of breath .	jumping jacks	Jumping Jacks
I did 20 jumping jacks , I felt out of breath .	jumping jacks	Jumping Jacks
I did twenty jumping jacks . I feel energized !	jumping jacks	Jumping Jacks
I did a bunch of jumping jacks . I felt exhausted but accomplished .	jumping jacks	Jumping Jacks
I did 12 jumping jacks . I felt energetic .	jumping jacks	Jumping Jacks
MY WORKOUT IS JUMPING JACK   GOOD FEEL	JUMPING JACK	Jumping Jacks
I did three minutes of jumping jacks . I feel out of breath .	jumping jacks	Jumping Jacks
I did 25 jumping jacks .   I am so exhausted !	jumping jacks	Jumping Jacks
i jump passing the ball    it was fun	jump	Jumping Jacks
Doing Jumping jacks It felt very intense and tiring during the excercise , but very relaxing afterwards	Jumping jacks	Jumping Jacks
I did 50 jumping jacks felt fine - heart was was up but i was feeling doos	jumping jacks	Jumping Jacks
i did 30 jumping jacks i was extremely tired after	jumping jacks	Jumping Jacks
I just did forty jumping jacks i feel bad	jumping jacks	Jumping Jacks
I just did 35 jumping jacks in under 90 seconds ! My legs are so shaky and I ca n't stand anymore .	jumping jacks	Jumping Jacks
I skipped rope for 15 minutes I felt great	skipped	Jumping Jacks
I did jumping jacks . during - felt like I was dying after - felt like I was dying to a lesser extent	jumping jacks	Jumping Jacks
I did 50 jumping jacks . I felt great !	jumping jacks	Jumping Jacks
I did 30   jumping jacks . I should do more , I did n't feel challenged by the exercise .	jumping jacks	Jumping Jacks
I just did 100 jumping jacks I felt sore	jumping jacks	Jumping Jacks
I did 20 jumping jacks I 'm slightly out of breath	jumping jacks	Jumping Jacks
I did jumping jacks for 20 minutes . I felt inefficient .	jumping jacks	Jumping Jacks
MY FIRST WORKOUT IS JUMPING JACK   REALLY I AM GOOD FEEL	JUMPING JACK	Jumping Jacks
i did five jumping jacks it was fun	jumping jacks	Jumping Jacks
I did 30 jumping jacks . My legs were aching afterwards .	jumping jacks	Jumping Jacks
I just completed 50 jumping jacks . I am out of breath and my heart is racing .	jumping jacks	Jumping Jacks
I just completed 100 jumping jacks . I am out of breath and tired .	jumping jacks	Jumping Jacks
I did jumping jacks and felt tired	jumping jacks	Jumping Jacks
I did 300 jumping jacks and felt sore	jumping jacks	Jumping Jacks
I just did 50 jumping jacks . I 'm really out of breath .	jumping jacks	Jumping Jacks
I did one jumping jack . I felt lazy .	jumping jack	Jumping Jacks
I did 4 sets of 20 jumping jacks . I was exhausted and needed to sit down .	jumping jacks	Jumping Jacks
i had to do 3 sets of jumping jacks i though this one would never end	jumping jacks	Jumping Jacks
I did 250 jumping jacks in a few minutes I felt invigorated .	jumping jacks	Jumping Jacks
I did one hundred jumping jacks . I was so tired after doing all of them .	jumping jacks	Jumping Jacks
skipping . i feeling its very energetic and give flexibility to my hip .	skipping	Jumping Jacks
I did 20 jumping jacks I feel energized .	jumping jacks	Jumping Jacks
I did 50 jumping jacks . I was very tired	jumping jacks	Jumping Jacks
I did 500 jumping jacks . I felt fatigued .	jumping jacks	Jumping Jacks
I just jumped on the trampoline for an hour . I feel dizzy .	jumped	Jumping Jacks
  I did jumping jacks I got tired	jumping jacks	Jumping Jacks
I hit a punching bag for 15 minutes I felt invigorated	hit	Martial Arts
i did karate for one hour i felt like i was having fun	karate	Martial Arts
I just did a 1 hour jiu - jitsu workout .   I feel tired .	jiu - jitsu	Martial Arts
I went kickboxing and felt clearminded after	kickboxing	Martial Arts
I just boxed for 30 minutes . I felt my arms being more muscular .	boxed	Martial Arts
I practiced lightsaber techniques for thirty minutes . It was fun , but my arms are tired .	lightsaber techniques	Martial Arts
I just lifted five sets of bench presses ! I feel sore	bench presses	Bodyweight exercises, general
I did butterflys on a weight machine . I felt like I was getting started .	butterflys	Bodyweight exercises, general
i just did 20 body weight dips my triceps feel like jello	  body weight dips	Bodyweight exercises, general
I did ten sets with 12 pound free weights . I felt more tone .	did ten sets	Bodyweight exercises, general
PUCHING THE BAG IT IS TOO GOOD	PUCHING	Bodyweight exercises, general
I did an exercuse video for 20 minutes . I was exhausted !	exercise video	Bodyweight exercises, general
I did some leg lifts I felt tired	leg lifts	Bodyweight exercises, general
I used the strength machines for 30 minutes . My muscles were very sore .	strength machines	Bodyweight exercises, general
I worked out at the gym . I felt motivated .	worked out	Bodyweight exercises, general
I performed some sets of crunches and push ups at home . I felt quite tired and sore both during and after .	sets of crunches and push ups	Bodyweight exercises, general
I lifted weights in the gym . I felt like a beast !	lifted	Bodyweight exercises, general
I did chest dip I was out of breathe	chest dip	Bodyweight exercises, general
weight lifting is good for the health It gives more strength on my overall body	weight lifting	Bodyweight exercises, general
I did stretching exercises for fifteen minutes . I feel prepared for a longer workout .	stretching	Bodyweight exercises, general
I did weight lifting I was drained	weight lifting	Bodyweight exercises, general
I did twenty five jumping jacks . I felt out of breath !	jumping jacks	Bodyweight exercises, general
I worked in the garden today .    My back is killing me .	worked	Bodyweight exercises, general
I used the rowing machine for 30 minutes   I feel energized	rowing machine	Bodyweight exercises, general
I did a 2 hour dance class . I felt so enlightened .	dance	Dancing
I danced in heels for an hour and my legs were sore !	danced	Dancing
I just danced for 40 minutes . I felt energized .	danced	Dancing
I spent two hours practicing tap dancing at home .   I feel so beat and breathless .	tap dancing	Dancing
I practiced choreography I am out of breath	choreography	Dancing
I just danced 1 hour of NIA . I feel happy .	danced	Dancing
I danced for 30 mins . Feeling very worn out .	danced	Dancing
I just finished a 2 hour long ballet class My body feels tired but I also feel uplifted	ballet class	Dancing
I did my 10 minutes hola hoop dance this morning . It feels good to get back on my hola hoop workout again .	hola hoop dance	Dancing
I danced for 30 minutes today . I felt wonderful after dancing .	danced	Dancing
I went dancing   I felt energized	dancing	Dancing
I did 30 mins of belly dancing . I felt exhilarated and sexy .	belly dancing	Dancing
""""""" I did a dance fitness class . """" """" I am tired and out of shape . """""""	dance	Dancing
I took a Zumba class this afternoon at a studio .   I felt extremely tired but , I felt good afterwards .	Zumba class	Dancing
I just completed 10 minutes of planks My abs will be burning tomorrow	planks	Planking
I held a 3 minute plank I feel exhausted but powerful	plank	Planking
i did planks my abdomen was hurt	planks	Planking
I did 3 sets of 1 minute planks and I was feeling great .	planks	Planking
I planked for so long that it hurt my core for three days .	planked	Planking
I did a plank for one minute . I felt like time was n't moving and my shoulders started to hurt real bad .	plank	Planking
standard plank on elbows straight across stronger	plank	Planking
Held a 3 minute plank My arms are shaky but feeling powerful	plank	Planking
I completed a 3 minute static plank hold . I started sweating and my body began to tremble during the exercise .	static plank hold	Planking
I just did a one minute plank .   It was hard but I made it !	plank	Planking
I did three sets of 15 planks . I feel sore and glad that they 're over .	planks	Planking
I did plank exercises for five minutes today . Every muscle in my body is sore .	plank	Planking
I did 20 planks and held for 45 seconds each . My arms and legs are on fire !	planks	Planking
""""""" I held a floor plank for a minute and a half """" """" My core muscles are feeling strong ! """""""	floor plank	Planking
I began doing planks . I felt very out of shape , could hardly breathe .	planks	Planking
I did 20 plank ups I felt shaky though strong and powerful .	plank ups	Planking
I did a plank in my home I felt relax and happy mood .	plank	Planking
I just did Planks for 20 minutes My core felt tighter afterward	Planks	Planking
I jusy did my first plank My abs are on fire !	plank	Planking
I just do 10 min high plank I Feel so tired	high plank	Planking
[ Idid a plank running in place for 1 minute I felt good	plank	Planking
I just did four cycles of fifteen seconds plank My arms and shoulders felt sore afterwards	plank	Planking
I just did a 5minutes straight - arm plank it was horrible	straight - arm plank	Planking
I did a minute plank today . My body was shivering during the exercise but I made it through and felt great afterwards .	plank	Planking
Ijust finished doing a plank for 3 minutes I felt good after doing it	plank	Planking
I just did a flexibility training   It was awesome	flexibility training	Planking
I did a toning butt workout and it did nt hurt after the first time but did the second day .	Butt workout	Lunges
I just did lunges up a huge hill I felt like my body was giving out on me	lunges	Lunges
I did lunges across the room .    I felt very worked but felt really good	lunges	Lunges
I lunged with dumbbells . I felt out of shape .	lunged	Lunges
I just did 20 minutes of lunges . My legs are shaky and wobbly .	lunges	Lunges
did split squats and felt exhausted .	split squats	Lunges
I just did 10 lunges on each leg .   I 'm a lot weaker than I thought I was !	lunges	Lunges
I just did three sets of lunges . My legs are shaky and it is difficult to walk .	lunges	Lunges
I just did 50 leg lunges per leg ! My legs feel like jello .	leg lunges	Lunges
I did 50 walking lunges . My butt and thighs were burning !	walking lunges	Lunges
I did 4 sets of 20 lunges   I felt tired and my leg are sore already	lunges	Lunges
I did 3 sets of reverse lunges It was really hard . My knees were sore today .	reverse lunges	Lunges
Lunges are very challenging but I love doing them . My legs were burning and kind of wobbly . I loved the feeling .	Lunges	Lunges
I did 45 lunges . I feel like I could jump over the moon .	lunges	Lunges
I did 30 minutes on the stairmaster today . I was exhausted and sweating like a pig	stairmaster	Stair Climbing
My second workout was a cardio workout where I ran up and down my stairs . I felt sweaty and tired .	stairs	Stair Climbing
I did 10 sets of 20 steps today . I could n't hardly get through it .   I 'm so out of shape .	steps	Stair Climbing
I have tried the stairmaster I could't do it , I felt misserable	stairmaster	Stair Climbing
stair climber terrible	stair climber	Stair Climbing
  A few days ago I did stair steps   and now my heel is sore	steps	Stair Climbing
I climbed 30 flights of stairs . My legs are going to be sore tomorrow , they 're on fire !	climbed stairs	Stair Climbing
I did 5 minutes on the stair machine . My thighs were very sore	stair machine	Stair Climbing
I climbed stairs for 100 floors and I felt pooped	stairs	Stair Climbing
i climb 700 steps on the stair climber . I was exhausted after i completed .	climb	Stair Climbing
I climbed six flights of stairs I am really out of breath .	climbed	Stair Climbing
I did 30 minutes of the stairmaster and I am so exhausted now !	stairmaster	Stair Climbing
I walked up the stairs to work . My legs are exhausted .	stairs	Stair Climbing
I climbed stairs 20 times I felt good that I had done it	climbed stairs	Stair Climbing
Stairclimbing for 5 minutes Now my legs hurt AND I 'm gon na have a heart attack .	Stairclimbing	Stair Climbing
I climbed stairs for ten minutes . My knee hurt .	climbed	Stair Climbing
I did 30 minutes on the stair climber machine I felt challenged and I was feeling my heart rate go up .	stair climber	Stair Climbing
I used the stair climber machine for 30 minutes . I felt sore and exhausted afterwards .	stair climber	Stair Climbing
I did the stair master for 30 minutes today my legs felt tired after this exercise	stair master	Stair Climbing
I just completed 15 minutes on the step machine . I am tired .	step machine	Stair Climbing
I walked 13 flights of stairs . I did not enjoy it all like I do hiking	stairs	Stair Climbing
I worked out for 10 minutes on the Stairclimber It felt great and motivated me to do it again tomorrow .	Stairclimber	Stair Climbing
I climbed 50 flights on the stair master . I felt energized .	climbed	Stair Climbing
I used the stair - climber machine for 3 minutes . I 'm so exhausted !	stair - climber machine	Stair Climbing
I just walked stairs for 30 minutes . I felt energized .	stairs	Stair Climbing
I cross country skied 4 miles . I was nervous to fall , but did n't at all !	skied	Skiing
I skiied for an hour today It was hard but exhilarating	skiied	Skiing
I skied 12 kilometers . I feel vigorous .	skied	Skiing
I just did 40 pull ups My arms are tired	pull ups	Chin ups
I did 5 set of 9 wide chinups and then 5 more sets of close chinups . My back muscles felt sore afterwards , but I felt satisfaction and a sense of achievement .	chinups	Chin ups
I just did a full rep of chin ups . I felt great	chin up	Chin ups
I did 16 chin - ups I feel like I can conquer the world ! I beat my record today =)	chin - ups	Chin ups
I did 5 pull ups on a workout bar I must have gained weight !	pull ups	Chin ups
20 assisted pull ups   arms are weak and crampy	pull ups	Chin ups
I played football for three hours . I felt sore after the game .	football	American Football
I played football for 2 hours . I felt sore after .	played	American Football
I played a touch football game with the neighborhood kids . I felt accomplished from burning calories .	touch football	American Football
I PLAYED FOOTBALL WITH MY SON FOR THE PAST 2 HOURS AND IM FEELING GREAT	PLAYED FOOTBALL	American Football
I play one hour for Foot ball I feel fresh	Foot ball	American Football
I have played football . I have very tired	football	American Football
I power walked for half an hour and I felt energised and made me feel good .	power walked	Walking
I just walked 3 miles this morning . I feel energized !	walked	Walking
I walked briskly for two miles on the nature trail Afterward , I felt full of energy	walked briskly	Walking
I went on the treadmill at the gym .   I felt calm but , tired after walking all those steps .	treadmill	Walking
I took a fast walk for half an hour . I felt very good ! Especially in an outdoor environment .	fast walk	Walking
I walked 3 miles . I felt sweaty and invigorated .	walked	Walking
i am every morning play a volley ball I am really strong my body fitness	volley ball	Volleyball
volley ball i feel brisk	volley ball	Volleyball
volley ball i felt relaxation	volley ball	Volleyball
I played volleyball for 2 hours and am tired	volleyball	Volleyball
I played volleyball for an hour . I felt terrific .	volleyball	Volleyball
I just played a one hour game of volleyball . I feel energized !	volleyball	Volleyball
I played sand volleyball for an hour last night .   I am out of shape ; I feel like I got hit by a truck .	volleyball	Volleyball
I played an hour volleyball game . I feel exhausted .	volleyball	Volleyball
Volleyball i felt happy	Volleyball	Volleyball
I played Volleyball for an hour I am really out of shape and tired .	Volleyball	Volleyball
I played volleyball in a tournament . I was tired .	volleyball	Volleyball
I just Play volley ball i am really out of shape	volley ball	Volleyball
I played volleyball for three hours earlier I still feel really sore	volleyball	Volleyball
I played volleyball for one hour . It felt terrific .	volleyball	Volleyball
I played badminton for 30 minutes .   I feel tired but happy to get my workout in .	played badminton	Badminton
I played a game of badmitton for 30 minutes . I was sore immediately afterward .	badmitton	Badminton
Playing badminton I feel excited playing with opponents that are similar level as me	badminton	Badminton
I walked for ten minutes on my treadmill . I was sweaty and my right calf muscle ached .	walked	Treadmill
I completed 5 miles while on the treadmill for 90 minutes today . It was great and I now have more energy !	treadmill	Treadmill
I ran for 30 minutes on the treadmill at a 9 minute pace I felt a little tired but overall good	ran	Treadmill
I walked on the treadmill for an hour . I feel weak and out of shape .	treadmill	Treadmill
I did 30 mins on the treadmill . I felt bored and tired .	treadmill	Treadmill
Ran 30 minutes on the treadmill I felt really tired , but happy i completed my goal	Ran	Treadmill
I walk a mile on the treadmill . I was sweating .	walk	Treadmill
My first workout was on the treadmill and it was exhausting . I felt very tired	treadmill	Treadmill
30 minutes on a treadmill i felt satisfied	treadmill	Treadmill
I did the treadmill again and I felt tired   I felt like i ran better than my first time .	treadmill	Treadmill
I ran on the treadmill today for 30 minutes . I feel so tired and exhausted .	treadmill	Treadmill
i like treadmil i like it because it good for health	treadmil	Treadmill
treadmill for 35 min . at 3 mph i felt great	treadmill	Treadmill
I just did 15 minutes on the treadmill I 'm feeling strong	Treadmill	Treadmill
I ran on the treadmill for 45 minutes I felt tired and worked	ran	Treadmill
I did the treadmill an ran for 30 minutes I felt really tired	treadmill	Treadmill
I did 45 minutes on the treadmill It was exhilerating	treadmill	Treadmill
I did a warmup jog on the treadmill for one mile . It got my energy going to keep working out .	jog on the treadmill	Treadmill
I just did 10 minutes on the treadmill I feel energized	treadmill	Treadmill
I went on the treadmill at the gym . My legs were hurting after I completed the exercise .	treadmill	Treadmill
I went on the treadmill for 30 minutes .   I felt sweaty and   shakey .	treadmill	Treadmill
i walked on a treadmill at 2.8 mph for 30 minutes i felt that i could do more .	treadmill	Treadmill
My first workout was in high school where I only ran on the treadmill for about half hour I was kind of tired afterwards but felt absolutely remarkable	ran	Treadmill
I walked half an hour on the treadmill . I felt exhausted and dehydrated .	walked	Treadmill
in the gym I did 30 minutes on the treadmill at a very average speed I kept wanting to give up before the 30 minutes but I was determined to finish the 30 minutes	treadmill	Treadmill
I did the treadmill for 30 minutes and I felt more energetic , refreshed , and happy for what I did .	treadmill	Treadmill
I did the treadmill for 30 minutes . I am so tired .	treadmill	Treadmill
I used the rowing machine at the gym for 30 minutes . My shoulders and back are killing me .	rowing machine	Rowing
I rowed 10 minutes on the rowing machine . I was completely exhausted .	rowing machine	Rowing
I rowed 15 minutes on the rowing machine in 5 minute intervals with 1 minute rest in between . I was exhausted and sweating much harder than the first workout .	rowing machine	Rowing
I rowed for fifteen minutes on the rowing machine i felt excited as I am getting back to exercising again	rowed	Rowing
I did four miles on the rowing machine . My arms were burning .	rowing machine	Rowing
I used the rowing machine for 20 minutes in the early morning .   I felt tired in my muscles and my heart was racing but I was very alert and ready to get to my paperwork .	rowing	Rowing
I rowed for 3 hours . I am exhuasted .	rowed	Rowing
I used the rowing machine at the gym for about 30 min today . I felt very accomplished but worn out .	rowing machine	Rowing
My next workout was the row machine . My shoulders feel fatigued .	row	Rowing
I went rowing on the ERG machine . I felt tired afterwards .	rowing	Rowing
3000 M row Getting faster .	row	Rowing
I stretched my legs on the rowing machine . I felt worn out !	rowing machine	Rowing
I used a row machine . I felt out of breath .	row machine	Rowing
I did 10 minutes on the rowing machine My legs are so sore .	rowing	Rowing
I did rows on the row machine . I feel nice and warmed up for other exercises .	rows	Rowing
I participated in a zumba dance class I felt exhausted yet invigorated	zumba	Zumba
I spent an hour doing Zumba .   I was ready to do more .	Zumba	Zumba
I did an hour of zumba I felt like I was gasping like a fish and a 1,000 degrees hot	zumba	Zumba
I went to Zumba today ! So glad I went ! Feel so much better !	Zumba	Zumba
I took a one hour Zumba class I feel energized	Zumba	Zumba
I danced for an hour I felt energized	danced	Zumba
I attended zumba for 1 hour it felt refreshing	zumba	Zumba
I went for Zumba class for 45 min I felt energized	Zumba class	Zumba
I did a 1 hour zumba class today . I felt very tired and sweaty .	zumba	Zumba
I did zumba for 50 minutes . It made me feel energized .	zumba	Zumba
I just did a 45 minute Zumba Gold Class I felt fantastic	Zumba Gold Class	Zumba
I just finished 30 minutes of Zumba I was exhausted but yet energized	Zumba	Zumba
I danced in my Zumba class today I felt exhausted after .	Zumba	Zumba
I continue with cardio and dance fitness for at least a couple of weeks before i start adding in weights and weigh lifting i felt even better and still accomplished a lot of housework and such because i had a lot of energy after	dance fitness	Zumba
I just completed a 30 minute cardio dance workout I can barely catch my breath	cardio dance workout	Zumba
When i first start working out i do a lot of cardio and dance fitness and make sure i drink plenty of water i felt great , it definitely helps wake me up and gets me energized	dance fitness	Zumba
I went to a Zumba class It made me sweaty	Zumba	Zumba
I did a cardio dance workout .   I was so winded and totally exhausted when I was finishing .  	cardio dance	Zumba
I did a 60 minute zumba class . I had a lot of fun but I was tired and sore by the end of the workout .	zumba class	Zumba
I danced actively for 35 minutes I felt full of energy and positive	danced	Zumba
I did a zumba class today . I felt energized	zumba	Zumba
I did an hour of Zumba today I felt motivated	Zumba	Zumba
I just did a zumba workout for 30 minutes on youtube I could barely keep up and had to keep pausing the video	zumba	Zumba
I went for a kickboxing class at the gym . I feel exhausted and sore .	kickboxing	Kickboxing
I did a 60 minute cardio kickboxing workout I really need to work on flexibility / mobility !	cardio kickboxing	Kickboxing
I did an hour of martial arts . I felt out of shape .	martial arts	Kickboxing
I just did my first kickboxing workout . My legs feel like tree trunks .	kickboxing	Kickboxing
I attended a two hour kickboxing class After my first work out , I felt like my legs were going to fall off	Kickboxing	Kickboxing
Boxing with Gym Bag It was exhausting	Boxing	Kickboxing
I did a kickboxing class today . I felt tough after my workout .	kickboxing class	Kickboxing
I spent an hour in a kickboxing class . My arms are worn out , but my legs feel great .	kickboxing class	Kickboxing
I just finished a one hour kickboxing class . I feel energized now .	kickboxing	Kickboxing
I WORKED OUT ON THE KICK - BOXING MACHINE I FEEL STRONG	KICK - BOXING	Kickboxing
I tried kick boxing today . I thought I was going to die .	kick boxing	Kickboxing
I completed a 30-minute cardio kickboxing workout . I could barely lift my arms afterwards !	cardio kickboxing	Kickboxing
I took a 30 minute kick - boxing class . I felt good but exhausted .	kick - boxing class	Kickboxing
I did kickboxing   I was tired	kickboxing	Kickboxing
15 minute flexed arm hang A little shaky	flexed arm hang	Pull ups
I do pull ups everyday . I feel invigorated when doing pull ups ..	pull ups	Pull ups
My workout consisted of 12 pull ups i feel wonderful but i am not don yet i have to reach my goal	pull ups	Pull ups
I did pull ups on a bar . I'm exhausted and sore now .	pull ups	Pull ups
I DID 15 PULL - UP I FELT EXHUASTED	PULL - UP	Pull ups
I take pullups 4 set daily i felt very powerful	pullups	Pull ups
my first workout is pull ups while doing this workout be get struggle to pull body up and down after doing this workout we get pain in wings and chest	pull ups	Pull ups
I did 10 pull ups .   I feel powerful .	pull ups	Pull ups
I did 10 pull - ups . I feel a little tired .	pull - ups	Pull ups
I did 10 pullups I felt heavy	pullups	Pull ups
I just did 25 pull ups I felt sore afterwards	pull ups	Pull ups
I just did 15 pull ups My shoulders are very tired	pull up	Pull ups
I take a pullups in everyday its felt to me very excitement	pullups	Pull ups
pull ups felt like death	pull ups	Pull ups
I did pull ups I felt energized	pull ups	Pull ups
I did 200 dead hang pull = ups today I felt really strong and in control during this exercise	pull = ups	Pull ups
I did 5 pull ups . My arms were shaking at the end of my third pull up .	pull up	Pull ups
I did 50 pull ups . My arms feel sore .	pull ups	Pull ups
Pull Ups i feel healthy	Pull Ups	Pull ups
I did 6 assisted pull ups . I 'm so weak right now !	pull ups	Pull ups
I completed 10 consecutive pull ups . My grip started to weaken and I felt fatigue in my lats .	pull ups	Pull ups
i did 100 pull ups   i felt like my back was going to explode	pull ups	Pull ups
Pull ups My arms were so sore i was at muscle failure	Pull ups	Pull ups
I SKIPPED 200 TIMES I FELT TIRED	SKIPPED	Pull ups
I did one pull up .   I felt proud .	pull up	Pull ups
I played 2 hours cricket .   It was excruciating .	cricket	Cricket
I SCORED 75 RUNS IN CRICKET   I FELT AWESOME	CRICKET	Cricket
I did a youtube workout   It was hard but felt good	youtube	Cardio
I took a Zumba class today . I feel out of shape but feel good .	Zumba	Cardio
I walked 2 miles on the trail today I am exhausted and ready for a nap now .	walked	Cardio
I just finished 35 minutes on the elliptical machine . I felt out of shape !	elliptical	Cardio
I did a 30 minute cardio . I was wore out but energized as well .	cardio	Cardio
I did a step class at the gym today . I felt exhilarated .	step class	Cardio
I just did 60 minutes of cardio . I 'm exhausted and hungry .	cardio	Cardio
I just did a HIT workout My legs feel like jello , i 'm so out of shape .	  HIT workout	Cardio
I did a HIT class at my gym . I felt good . It challenged me .	HIT class	Cardio
Rebounding day 2 I was extremely sore but was proud of what I accomplished	Rebounding	Cardio
Just did a cardio workout . I feel energized .	cardio	Cardio
I completed a 30 minute low impact session . I 'm huffing and puffing !	low impact	Cardio
I just completed an RPM class . I really pushed myself .	RPM class	Cardio
Met with my boot camp group this morning we kicked each others butts !	boot camp	Cardio
I did 15 minutes on the exercise bike .   I was energized .	exercise bike	Cardio
I did one hour of cardio playing Just Dance at the gym today . I was totally exhausted by the end of it .	cardio	Cardio
I did 20 minutes of cardio I feel like I am short of breath	cardio	Cardio
I did a cardio video . It felt energizing and fun .	cardio	Cardio
I went to the gym and did 20 minutes of cardio .   I was tired and pretty exhausted or I would have done more time .	cardio	Cardio
I did 15 minutes on the elliptical .   It was hard to keep going but I made it through !	elliptical	Cardio
I just did 45 minutes of cardio . I was so tired , but felt accomplished .	cardio	Cardio
I stepped 200 steps on the stair climber . I felt tired and sweaty after my workout	stepped	Cardio
I conditioned with my cheerleading team . I felt exhausted .	conditioned	Cardio
I ran three miles on a treadmill today . I felt a little tired in the beginning , but recovered by the end .	ran	Cardio
I used the step climber for 30 minutes .   I am totally drained .	step climber	Cardio
I ran 3 laps around my house . I 'm completely out of breath !	ran	Cardio
I did a 20 minute cardio dvd . I felt energized afterwards .	cardio dvd	Cardio
I just did 50 burpees I feel very light headed now	burpees	Burpees
I did 250 burpees Burpees feel awkward and I 'm not sure it is a good workout	burpees	Burpees
i did 10 burpees i am exhausted	burpees	Burpees
I did a set of burpees .   I 'm so sore .	burpees	Burpees
I did burpees today I felt go after I was finish	burpees	Burpees
I did 12 burpees ! I felt fatigued .	burpees	Burpees
I did 20 burpees in 2 minutes I struggled with completing them in the time given	burpees	Burpees
I also did 50 burpees when I finished running . I was exhausted after completing the burpees .	burpees	Burpees
I did 25 burpees . I feel winded .	burpees	Burpees
I just did 45 burpees I felt out of breath .	burpees	Burpees
I did 30 burpees . My arms and legs were screaming in pain toward the end .	burpees	Burpees
I did burpee at the gym I felt tried	burpee	Burpees
I did three sets of 10 of bungee jumps . My whole body hurts and is sore .	bungee jumps	Burpees
I did 60 seconds of burpees . I felt out of breath .	burpees	Burpees
I did 20 burpees I felt amazing and awake	burpees	Burpees
I went out and did a numerous amount of burpies .   Now am extremely sore and regretting that decision .	burpies	Burpees
i did 50 burpees i was out of breathe	burpees	Burpees
I work one hour gym I feel very comfortable	gym	Burpees
I just did 3 sets of 10 burpees . I feel like I am going to pass out .	burpees	Burpees
I did 10 burpees I felt like I worked out my entire body !	burpees	Burpees
I tried 20 burpees as fast as I could . I was out of breath by the time I finished .	burpees	Burpees
3 sets of burpees I feel completely spent	burpees	Burpees
I performed 20 burpees . My arms and chest were burning during this .	burpees	Burpees
I just did 10 burpees I nearly passed out	burpee	Burpees
My second exercise was intense exhausted	My second exercise was intense	Burpees
Went climbing at Red Rocks for 2 hours My hands feel a little cramped up	climbing	Rock climbing
I did some rock climbing . My arms felt like jello afterwards .	climbing	Rock climbing
I rock climbed for an hour . It was very tiring and my hands hurt .	rock climbed	Rock climbing
i played squash for an hour i felt exhausted	squash	Squash
I did 50 pull - ups , 100 push - ups , and 150 squats today . My arms is feeling numb , it hurts when I sit down .	pull - ups push - ups squats	Crossfit
I did a circuit with the trainer I 'm going to be so sore tomorrow	circuit	Crossfit
I did 50 thrusters . I 'm starting to feel a little lightheaded .	thrusters	Crossfit
"""I did CrossFit workout """" Fran """" . I felt great after the workout !"""	CrossFit	Crossfit
I did CINDY in the CrossFit workout   I felt energized	CrossFit	Crossfit
I went to Crossfit this morning I felt good	Crossfit	Crossfit
I just kayaked for 5 hours .   I feel sore .	kayaked	Kayaking
I went kayaking for one hour . I feel reinvigorated .	kayaking	Kayaking
push ups and dumbless workout make me feel healthy	push ups and dumbless workout	Dumbbells
SECOND WORKOUT FOR dumbell squats I AM SPEND MORE TIME	dumbell squats	Dumbbells
I lifted 25 pound dumbbells . My arms are tired !	lifted 25 pound dumbbells	Dumbbells
One hour workout lifting weights at the gym I feel great and have a great pump after lifting weights	lifting weights	Dumbbells
I lifted 10 pound weights on each arm , 30 reps   My arms started shaking	lifted	Dumbbells
Managed to do 3 sets on the dumbells i was feeling tired but got ta keep going	dumbells	Dumbbells
I did some dumbell squats It was a rough set .	squats	Dumbbells
I performed five sets of dumbbell squats I felt tired	dumbbell squats	Dumbbells
I pushed dumbells two sets at a time . Pumped up .	dumbells	Dumbbells
I just did an upper body dumb bell workout .   It made my arms feel so weak .	dumb bell	Dumbbells
i did tricep extensions i am feeling good	tricep extensions	Dumbbells
I curled my weights . I felt good and clear - headed .	curled	Dumbbells
lifting weights was tough on my arms felt tired and sore after the workout	lifting weights	Dumbbells
SECOND WORKOUT DUMBELL SQUATS I AM SPENT MORE TIME IN SECOND WORKOUT	DUMBELL SQUATS	Dumbbells
I lifted weights in the gym for 30 minutes . I felt really strong during the workout , and did n't feel sore afterwards .	lifted weights	Dumbbells
two sets of dumbbell squats     feel grained and tried	dumbbell squats	Dumbbells
I lifted 2 lb . dumbbells for 20 minutes . I could feel my muscles straining as I lifted the weights	dumbbells	Dumbbells
I lifted four sets of shoulder press at the gym today . I felt great during the workout and sore afterwards .	shoulder press	Dumbbells
lifting weights again felt less sore than before	lifting weights	Dumbbells
I used dumbbells to do a upper body workout My muscles felt sore afterwards .	upper body workout dumbbells	Dumbbells
I just play foot ball   This is improve my body fitness	foot ball	American Football
i am every evening play a table tennis i am really out of shape	table tennis	Table tennis
I played shuttle game It was very good and healthy	shuttle game	Table tennis
second workout was jumping that was good	jumping	Jumping rope
I just completed a jump rope exercise I now feel accomplished and energized	jump rope	Jumping rope
I jumped rope for 10 minutes . I feel jiggly and tired !	jumped rope	Jumping rope
I did 30 minutes of jump rope . I felt high energy during the workout .	jump rope	Jumping rope
i did some jump rope it was very difficult	jump rope	Jumping rope
I jumped rope for 5 consecutive minutes I am winded and sweating profusely	jumped rope	Jumping rope
I jump - roped for twenty minutes . I am winded !	jump - roped	Jumping rope
I just jumped rope for three set of 30 seconds My legs feel like jelly	jumped rope	Jumping rope
I jumped rope for 30 minutes . I felt exhausted .	jumped rope	Jumping rope
I did 100 jump ropes I felt exhausted .	jump ropes	Jumping rope
I jumped rope for five minutes . It felt good !	jumped	Jumping rope
I DID 100 PUSHUPS I FELT CHEST PAIN	PUSHUPS	Jumping rope
I jumped rope for five minutes . I need to exercise more .	jumped rope	Jumping rope
I went to the gym and spent an hour using the strength - training machines . I was really sweating by the time I stopped ! My muscles are going to be sore tomorrow .	strength - training machines	Leg press
I lifted 40 pounds on leg press today . My legs are very sore after lifting on the leg press .	lifted	Leg press
leg press pretty good	leg press	Leg press
I just did 50 reps on leg press i feel sore	leg press	Leg press
3 sets of leg press 12 reps each set I felt like I am done for the day	leg press	Leg press
Leg press I have felt stronger in the past	Leg press	Leg press
I did 10 sets of leg extensions . The next day I could barely stand .	leg extensions	Leg press
I just did 40 leg presses at 50 pounds I feel proud and great	leg presses	Leg press
I did 3 sets of leg presses I feel tired but great and my legs feel a good burn	leg presses	Leg press
I did leg presses My thighs and butt are really stiff now	leg presses	Leg press
I just did 20 reps on the leg press . My legs feel like jello !	leg press	Leg press
I did the leg press at 150 pounds . I felt a good burn and good workout .	leg press	Leg press
i pumped a leg day i can walk like a cowboy	leg	Leg press
I did 50 leg presses at 50 pounds I felt proud that I went up 10 presses and 10 more pounds of weight today	leg press	Leg press
I just skated 13 miles across the city . I felt relaxed .	skated	Roller skating
I roller skated around the block . I felt amazing !	roller skated	Roller skating
I just pitched 9 innings . My arm feels like jelly .	pitched	Baseball
I played two hours baseball I 'm very exhausted	baseball	Baseball
I played baseball for one hour I felt sluggish	baseball	Baseball
I did a set of mountain climbers I feel tired .	mountain climbers	Mountain climbers
I did a floor exercise My arms were like jello	floor exercise	Mountain climbers
I just did 3 sets of doing mountain climbers for 60 seconds each I 'm already sweating !	mountain climbers	Mountain climbers
I just did some leg lifts .   My stomach feels weak .	leg lifts	Leg Raises
I did fifteen leg lifts on each leg . I felt stretched and ready to go , l	  leg lifts	Leg Raises
I did a set of leg lifts I felt very tired	leg lifts	Leg Raises
I did mostly ab workouts including leg lifts after I was done I felt sore in my back area	leg lifts	Leg Raises
I did 10 leg raises I felt it burn	leg raises	Leg Raises
I did 20 calf raises on each leg . I felt tired and fatigued .	calf raises	Leg Raises
doing leg curls at the gym . my legs hurt so bad .	curls	Leg Raises
I just boxed 4 rounds on the heavy bag I felt great afterwards	boxed	Boxing
I did fourty five minutes of boxing I could n't walk after the first day	boxing	Boxing
I went to a boxing class It was so much fun and I feel great !	boxing	Boxing
I boxed for 1 hour .   I feel incredible !	boxed	Boxing
I did a boxing class at the gym Excited but tired	boxing class	Boxing
I ice skated for two hours . I felt brave .	ice skated	Ice skating
I did 15 weight flys I felt sore	weight flys	Weights, general
I ran after my toddler and my infant and picked one up in each arm simultaneously . It was exhausting !	ran	Housework
I just spent an hour gardening . My back is killing me !	gardening	Housework
